+-+-+-+-+-+-+-+-+-+-+-+-+-+-+-+-+
|     | |     |       |         |
+-+-+ + +-+-+ + + +-+ + +-+-+-+ +
| | | |       | |   | |       | |
+ + + + +-+ + + + + + + +-+-+-+ +
| | | | | | | | | | | | |       |
+ +-+ + + + + + + +-+ + +-+-+-+ +
|       | | |     |   |       | |
+ +-+-+-+-+ + + + +-+ + +-+-+-+ +
| |     |   | | | | | | |       |
+ +-+-+-+ +-+ + + + + + +-+-+-+ +
|         |   | | | |         | |
+ +-+-+-+-+ +-+ + + + + +-+-+-+ +
|           |       | |       | |
+-+-+-+-+ +-+ +-+-+-+ + +-+-+ + +
|             |G    | | | | | | |
+ +-+-+ +-+-+ + + + + + + +-+-+ +
|             |   | |   |       |
+ + +-+-+-+-+ +-+-+ +-+-+-+-+-+ +
| |   | |     |   |     | | | | |
+ +-+-+ +-+-+-+-+ + +-+ +-+ + + +
|               |   |       | | |
+-+-+-+-+-+ +-+-+-+ + +-+-+ + + +
|                 |   | |   | | |
+ + +-+ +-+ + +-+-+-+ +-+ + +-+ +
| | | | | | | |   |   |   |     |
+ + + + + + + +-+ +-+ + +-+-+ + +
| | | | | | | | | | |     |   | |
+ + + + + + + +-+ +-+ +-+ + +-+ +
| | | | | |     | |     |   | | |
+ +-+ +-+ +-+-+-+ +-+-+-+ +-+-+ +
|                               |
+-+-+-+-+-+-+-+-+-+-+-+-+-+-+-+-+
