+-+-+-+-+-+-+-+-+-+-+-+-+-+-+-+-+
|             |   |             |
+-+-+-+ +-+-+ +-+-+ +-+-+ +-+-+ +
| |   | |   |       |   | |   | |
+ + +-+ +-+ +-+-+-+-+ +-+ +-+ + +
| | | |   |           |   | | | |
+ +-+-+ + +-+-+ +-+-+-+ + +-+-+ +
|       |     | |       | |     |
+ +-+-+ +-+-+ +-+ +-+-+-+ + +-+ +
| | | |   | |     |       | | | |
+ + +-+-+ +-+-+-+-+ +-+-+-+ +-+ +
| |       |         |     |     |
+ + +-+-+-+ +-+-+-+-+-+-+-+-+-+ +
|   |   |   |       |         | |
+-+ +-+-+-+ + + +-+ +-+-+-+-+-+ +
| |     | | | |G  | |           |
+ + +-+ + + + + + + + +-+-+-+ +-+
| | | | | | | |   | | |       | |
+-+ +-+ + + + +-+-+ + + +-+-+ + +
|       | | |       | |       | |
+ +-+ +-+ + +-+-+-+ + +-+-+-+ +-+
| | | |   | |     | |           |
+ +-+ +-+-+ + +-+ + +-+-+-+-+-+ +
|     |     | | | | |         | |
+ +-+-+ +-+-+ + + + +-+-+-+-+-+ +
|       | | | | | | |   |     | |
+ +-+-+-+ + + +-+ + +-+-+ +-+ + +
| | | | | | | | | |       | | | |
+ + +-+ +-+ + + + + +-+-+-+ + + +
| |   |     |   | |       | |   |
+ +-+-+ +-+ +-+-+ +-+-+-+ +-+-+ +
|       | |                     |
+-+-+-+-+-+-+-+-+-+-+-+-+-+-+-+-+
