+-+-+-+-+-+-+-+-+-+-+-+-+-+-+-+-+
|             |                 |
+-+-+-+-+ +-+ +-+ +-+-+-+-+ +-+ +
| |     | | | | |         | | | |
+ +-+-+-+ +-+ +-+ +-+-+-+ + +-+ +
|         |       |       | |   |
+ +-+-+-+-+-+-+-+-+ +-+-+-+ + + +
| |                 |       | | |
+ +-+ +-+ +-+-+-+-+-+-+-+-+ + + +
|     | | |               |   | |
+ +-+ +-+ + +-+ +-+-+ +-+-+-+ + +
| | | |   | | | |           | | |
+-+-+ + + + +-+ + +-+-+-+ + + +-+
|     | | | |   | |     | | |   |
+ +-+ + + + + +-+ + + + + + +-+ +
| | | | | | | |G  |     | | | | |
+ +-+ + + + + + + + + + +-+ +-+ +
|     | | | | |   |     | |     |
+ +-+ + + + + + +-+ + + +-+ +-+ +
| |   | | | | | | |     | | | | |
+ + +-+ + + + + + +-+-+-+ + +-+ +
| | | | | | | | |         |     |
+ + +-+ + + + + +-+-+-+-+ + +-+ +
| |       | | |         | | | | |
+ + +-+-+-+ + +-+ +-+ +-+ + + + +
| | |           | | | | | | | | |
+ + + +-+-+-+-+-+ + + +-+ + + + +
| | |             | |       | | |
+ + +-+-+ +-+-+-+-+ + +-+-+ + + +
| |       |         | |   | | | |
+ +-+-+-+-+ +-+-+-+-+ +-+-+ +-+ +
|                               |
+-+-+-+-+-+-+-+-+-+-+-+-+-+-+-+-+
