+-+-+-+-+-+-+-+-+-+-+-+-+-+-+-+-+
|     |     |   |   | |         |
+-+-+ + + + + + + + + + +-+-+-+ +
|   | | | | | | | | |   |   | | |
+ + + +-+ + + + + + + +-+ + + + +
| | |     | | | | |   |   | |   |
+ +-+ +-+-+ + + + + + + + + + + +
|     |       |   | | | | | | | |
+ +-+ +-+-+ + +-+-+-+-+ +-+ + + +
| | |     | | |       | |   |   |
+ + +-+-+-+ +-+ +-+-+ + + + + + +
|           |       | | | | | | |
+-+-+-+ +-+-+ +-+-+-+ + + + + + +
|         |         | | |       |
+ +-+-+-+-+ + +-+-+ + + + +-+-+ +
|       |   | |G  | | | |     | |
+-+-+-+ + + + + + + + + +-+-+ + +
|       | | | |     | | |       |
+ +-+-+-+ + + +-+-+ + + + +-+-+-+
|       | | |       |   |       |
+-+-+ +-+ +-+-+-+-+-+ +-+-+-+ +-+
|       |             |         |
+-+ +-+-+-+-+-+-+-+ +-+-+ +-+-+-+
|   |               | |         |
+ +-+ +-+-+-+-+-+-+-+ + +-+-+-+-+
| |     |       |   |   |       |
+ + +-+-+ +-+ + + + + + + +-+-+ +
| |           | | | | | | |   | |
+ +-+-+-+-+-+ + + + + + + +-+ + +
| |           |   |   | |     | |
+ +-+ +-+ +-+ +-+ + + + +-+-+-+ +
|         |       | | |         |
+-+-+-+-+-+-+-+-+-+-+-+-+-+-+-+-+
