+-+-+-+-+-+-+-+-+-+-+-+-+-+-+-+-+
|                           |   |
+-+ +-+-+ +-+-+ +-+-+-+ +-+ + + +
|   |   |       |     |       | |
+ +-+ + +-+-+-+-+ +-+ +-+-+-+-+ +
| |   |           |   |       | |
+ + +-+-+-+ +-+-+-+ +-+ +-+-+ + +
| |         |   |   |     |   | |
+ +-+ +-+ + + + + +-+ +-+ + + + +
|   |     | | | |     |     | | |
+ + + + +-+ + + + +-+-+ +-+ + + +
| | | |   | | | |         | | | |
+ + + + + + + + +-+-+-+-+ + + + +
| | |   |   |           | | |   |
+ + + + + +-+-+-+-+ +-+ + + + + +
| | | | | |   |G  | |   |   | | |
+ + + + + + + + + + + + + + + + +
|   | |   | | |       | | | | | |
+ +-+ + + + + +-+-+-+ + + + + + +
| |   | | | |           | |   | |
+ + +-+ + + + +-+-+ +-+ + + + + +
| |   | |   |           | | |   |
+ +-+ + +-+ +-+ +-+-+ +-+ + +-+ +
|   | |               |       | |
+ + + +-+-+-+-+-+-+-+-+ +-+-+ + +
| | |                       | | |
+ + +-+ +-+-+ +-+-+ +-+-+-+ + + +
| | |             |           | |
+ + +-+-+-+-+-+-+ +-+-+ +-+-+ + +
| |             |             | |
+ + + +-+-+-+ + +-+-+-+-+ +-+ + +
|   |         |                 |
+-+-+-+-+-+-+-+-+-+-+-+-+-+-+-+-+
