+-+-+-+-+-+-+-+-+-+-+-+-+-+-+-+-+
|           |           |       |
+-+-+-+-+-+ + +-+-+ +-+ + +-+ + +
|         | |       |       | | |
+ + + +-+ + + +-+ + +-+-+-+ + + +
| | |   | | |     | | |   | | | |
+ + + + + + +-+-+-+ + + + + + + +
| | | |   |           | | | | | |
+ + + +-+-+ +-+-+-+-+-+ + + + + +
| | |       |             | | | |
+ + +-+ +-+-+-+-+-+ + + + + + + +
|     | | |       | | | | | | | |
+ + +-+ + + + +-+ + + + + + + +-+
| | |   | | |     | | | | | |   |
+ + +-+-+ + + +-+-+ + + + + +-+ +
| | |     | | |G    | |   |     |
+ + + +-+ + + + + + + + + + +-+-+
| | | |   | | |   |   | | | |   |
+-+ + + + + + +-+-+-+ + + + + + +
|   |   | | | |     |   | | | | |
+ + + +-+ + + + +-+-+-+ + + + + +
| | | | | | |           | | | | |
+ + + + + + + + +-+-+-+-+ + + + +
| | | | | | | |           | | | |
+ +-+ + + + + +-+-+-+-+-+-+ + + +
|     | | | |       |       | | |
+ +-+-+ + + +-+-+-+ + +-+-+-+ + +
|       | |         |           |
+ +-+-+ + +-+-+-+-+ +-+-+-+-+-+ +
|       |               |     | |
+ +-+-+ + +-+-+-+-+ +-+-+ +-+-+ +
|       |                       |
+-+-+-+-+-+-+-+-+-+-+-+-+-+-+-+-+
