+-+-+-+-+-+-+-+-+-+-+-+-+-+-+-+-+
|               |               |
+-+-+ +-+-+-+ +-+ +-+-+ +-+ +-+ +
|                             | |
+ +-+ + +-+-+-+ +-+-+ +-+ +-+ + +
|     |   | |       |   | | | | |
+-+ +-+ + + + + +-+ + +-+ +-+ + +
|       |     |     | |     | | |
+ +-+ +-+ + +-+ +-+-+ +-+ +-+ + +
| |       |     |             | |
+ + +-+ +-+-+ +-+ +-+-+-+-+-+ + +
|                 |   |       | |
+ +-+ +-+ +-+-+-+-+ + + +-+-+-+ +
| |       |         | |         |
+ + +-+ +-+ +-+ +-+-+ +-+-+-+-+ +
|         |   |G  |   |       | |
+ +-+ +-+-+-+ + + + +-+ +-+-+ + +
|         |   |   |   | |     | |
+-+ +-+ +-+ +-+-+-+ +-+ + +-+-+ +
|     |   | |   |     | |     | |
+ +-+ +-+ + + + +-+ +-+ + +-+ + +
|   |   | |   |   |   | |     | |
+ + +-+ + +-+-+-+ + +-+ +-+ +-+ +
| |   |   |       |   |   |   | |
+ + + +-+-+ +-+-+-+-+ +-+ +-+ + +
|   |     |         |       |   |
+ +-+-+-+-+-+-+-+-+ +-+-+-+ +-+ +
| |                     |   |   |
+ + +-+-+-+-+-+-+-+-+-+-+ +-+ + +
| |         |             |   | |
+ +-+-+-+-+ + +-+-+-+-+-+-+ +-+ +
|           |                   |
+-+-+-+-+-+-+-+-+-+-+-+-+-+-+-+-+
