+-+-+-+-+-+-+-+-+-+-+-+-+-+-+-+-+
|           |       |         | |
+-+-+-+ +-+ +-+-+-+-+ +-+-+-+ + +
| | | | | |           |     | | |
+ + + + + + +-+ +-+ +-+ +-+ + + +
| | | | | | | | | | | | | | | | |
+ +-+ + +-+ + + + + + + +-+ + +-+
|   | | |   | | | | | |     |   |
+ +-+-+ +-+ + + + + + +-+-+ +-+ +
| |       | | | | | |   |   | | |
+-+ +-+-+ + +-+ +-+ + + + + +-+ +
| | | | | |         | | | | | | |
+-+ +-+-+ +-+-+-+-+-+ + + + +-+ +
| |   |   | |         | | | | | |
+ +-+ + + +-+ +-+ +-+ + + + +-+ +
| | | | | | | |G  | | |   |     |
+ +-+ + + +-+ + + + + + + + +-+ +
|     | |   | |   | | | | | | | |
+ +-+ + + +-+ +-+-+-+ + + + +-+ +
| | | |   | |     | | | | | | | |
+ +-+ + + +-+-+-+ +-+ + + + +-+ +
|   | | | | | | | | | | | | |   |
+ + +-+ + +-+ + + + + + +-+ + + +
| |     | | | | | | |   |   | | |
+ + +-+-+ +-+ +-+ + +-+ + +-+ + +
| | |     |       |   | | |   | |
+ + + +-+ + +-+-+ + +-+ + +-+ + +
| | | | | | | | | | | | | | | | |
+ +-+ +-+ + +-+-+ + + + + + + + +
| | |     | | | | | | |   | | | |
+ + +-+-+-+ +-+-+ + +-+-+-+-+ + +
|           | | |               |
+-+-+-+-+-+-+-+-+-+-+-+-+-+-+-+-+
