+-+-+-+-+-+-+-+-+-+-+-+-+-+-+-+-+
|                               |
+-+ +-+-+-+-+-+-+ +-+-+-+-+-+-+ +
|                             | |
+ +-+-+-+-+-+-+-+-+-+-+-+-+-+ + +
| |                         | | |
+ + +-+-+-+-+-+-+-+-+-+-+-+ + + +
| | |                     | | | |
+ + + +-+-+-+-+ +-+-+-+-+ + + + +
| | | |                 | | | | |
+ + + + +-+-+-+-+-+-+-+ + + + + +
| | | | |             | | | | | |
+ + + + + +-+-+-+-+-+ + + + + + +
| | | | | |         | | | | | | |
+ + + + + + +-+-+-+ + + + + + + +
| | | | | | |  G  | | | | | |   |
+ + + + + + + + + + + + + + + + +
|   | |   | | |   |   | | | | | |
+ + + + + + + +-+-+ + + + + + + +
| | | | | | |       | | | | | | |
+ + + + + + +-+-+-+-+ + + + + + +
| | | | | |           | |   | | |
+ + + + + +-+ +-+-+-+-+ + + + + +
| | | | |               | | | | |
+ + + + +-+-+-+-+-+-+-+-+ + + + +
| | | |                   | | | |
+ + + +-+-+-+-+-+-+-+-+-+-+ + + +
| | |                         | |
+ + +-+-+-+-+-+-+ +-+-+-+-+-+ + +
| |                           | |
+ +-+-+-+-+-+-+-+ +-+-+-+-+-+-+ +
|                               |
+-+-+-+-+-+-+-+-+-+-+-+-+-+-+-+-+
