+-+-+-+-+-+-+-+-+-+-+-+-+-+-+-+-+
|           |                   |
+-+ +-+-+-+-+-+-+-+ +-+-+-+-+-+ +
|     |                 | |   | |
+-+ +-+-+ +-+-+-+-+-+-+-+ +-+-+ +
|               |       |       |
+-+-+ +-+-+-+ +-+ +-+-+ + +-+-+-+
| |     | |   |   |   | |       |
+ +-+ +-+-+ +-+ + + + + +-+-+-+ +
| |         |   | | | |   |   | |
+ +-+-+ +-+-+ + +-+ + + + +-+-+ +
|         |   | | | |   |     | |
+ +-+ + +-+ +-+-+ + + + + +-+ + +
| |   | |         | | | | | | | |
+ +-+-+-+ +-+ +-+-+ + +-+ + +-+ +
| |   |   |   |G  | | |         |
+ + + + +-+ +-+ + + + + +-+-+-+-+
|   |   |   |     | | | |       |
+ + + +-+ + + +-+-+ + + + +-+-+ +
| |   |   | |   |   | | | | | | |
+ + +-+ +-+ + + +-+ +-+ + + + + +
| | |   |   | | |     | | |     |
+-+ + +-+-+ + + +-+ +-+ + + + +-+
| | | |     | | |     |   | |   |
+ + + + +-+-+ + +-+ +-+-+-+ + +-+
|   | |     | |       |     |   |
+ + + +-+ +-+ +-+-+ +-+-+ +-+ +-+
| | |     |               |     |
+ + + +-+-+-+-+-+-+-+-+-+-+-+ +-+
|   |                           |
+ +-+-+-+-+-+-+-+-+-+-+-+-+ +-+-+
|                               |
+-+-+-+-+-+-+-+-+-+-+-+-+-+-+-+-+
