+-+-+-+-+-+-+-+-+-+-+-+-+-+-+-+-+
|                   | |         |
+-+-+ +-+ +-+-+ +-+ +-+ +-+ +-+ +
|   |     |     | |     |   | | |
+ +-+ +-+-+-+ +-+ +-+ +-+-+ +-+ +
|     |     |         |   |   | |
+ + +-+-+-+-+ +-+-+ + + + + +-+ +
| | | |             |   | | |   |
+ + + + +-+-+-+ +-+-+ + + + +-+ +
| | | | |     |       | | |     |
+ + + + + + + + +-+-+ + + +-+ + +
| | | | |     |       | |   | | |
+ + +-+ + + +-+ +-+-+-+ + + + + +
| |     |   |   |   |     | | | |
+ + + + +-+-+ +-+-+ +-+-+-+ + + +
|   | |       |G  | |   |   | | |
+ +-+ + + + +-+ + +-+-+-+-+-+-+ +
| |   | | | | |   |       |     |
+ +-+ + + + + +-+ + +-+-+ +-+-+ +
|   |   | | |   | |   |     |   |
+-+ + +-+ + +-+-+ + +-+ +-+ +-+ +
| |         | | |   |     |   | |
+-+ +-+ +-+-+ + + + + +-+-+-+ + +
|   |         | | |   |       | |
+ + + +-+-+-+ +-+ + + + +-+-+ + +
| | |         | | | | | | |   | |
+ + +-+-+-+ +-+ +-+ + + +-+-+ + +
| |       |     | | | | |   |   |
+ +-+ +-+ +-+-+-+ +-+ + + + +-+-+
| | | | |       | | |     | |   |
+ +-+-+ + +-+-+-+ + +-+-+-+ + + +
|                           |   |
+-+-+-+-+-+-+-+-+-+-+-+-+-+-+-+-+
