+-+-+-+-+-+-+-+-+-+-+-+-+-+-+-+-+
|                               |
+-+ +-+-+-+-+-+-+-+-+-+-+-+-+-+ +
|   |       |   |   |     |     |
+ +-+ +-+ +-+ + + + + +-+ +-+ + +
| |     |   | |   |   |   |   | |
+ +-+ +-+-+ + +-+-+-+-+ +-+ +-+-+
| |     |   |         | |   |   |
+ +-+ +-+ +-+-+-+-+-+ + + +-+ + +
| |     |   |         | |   | | |
+ +-+ +-+-+ + +-+-+-+-+ +-+ + + +
| |     |   |         |   |   | |
+ +-+ +-+ +-+-+-+-+-+ + + +-+-+ +
| |     |   |         | | | |   |
+ +-+ +-+-+ + +-+-+-+-+-+ + + +-+
| |     |   |  G  |     |   |   |
+ +-+ +-+ +-+-+ + + +-+ +-+ +-+ +
| |     |   | |   |   |   |     |
+ +-+ +-+-+ + + +-+-+ +-+ +-+ +-+
| |     |   | |     |   |   |   |
+ + +-+ + +-+ +-+-+ +-+ +-+ +-+ +
|       | |       |   |   |   | |
+ +-+ +-+ + +-+ + +-+ + +-+-+ + +
|   |   |   |   |   |       | | |
+-+ +-+ + +-+ +-+-+ +-+ +-+ + + +
|   |   | |   |   |   |   | | | |
+ +-+ +-+-+ +-+ + +-+ +-+ +-+ + +
|   |   |   |   |   |   |   | | |
+-+ +-+ + +-+ +-+-+ +-+ + + + + +
|       |     |   |   |   | | | |
+ +-+-+-+-+-+-+ + +-+ +-+-+-+ + +
|               |       |       |
+-+-+-+-+-+-+-+-+-+-+-+-+-+-+-+-+
