+-+-+-+-+-+-+-+-+-+-+-+-+-+-+-+-+
|           | |                 |
+-+-+-+-+-+ +-+-+-+ +-+-+-+-+-+ +
|                     |         |
+ +-+-+-+-+-+-+-+-+-+-+ +-+-+-+-+
| |               |             |
+ + +-+-+-+-+-+-+ +-+ +-+-+-+-+ +
| | |             | | | | |     |
+ + + +-+-+-+-+-+-+ +-+ +-+ +-+-+
| | |         |   |     |   |   |
+ + + +-+-+-+ +-+ + + +-+ +-+ + +
| | | |       |   | | | | |   | |
+ + + + +-+-+-+ + + + +-+ + +-+ +
|   | | |       |   | |   | |   |
+ + + + + +-+-+-+-+ + + +-+ + +-+
| | | | |     |G  | | | |   |   |
+ + + + +-+-+ + + + + + + +-+-+ +
| | | | |     |   | | | | |     |
+ +-+ + + +-+-+-+ +-+ + + + +-+-+
| |   |       | |     |   |     |
+ + + +-+ +-+ +-+-+-+ +-+-+-+-+ +
| | |   |   | |                 |
+ + +-+ +-+-+ +-+ +-+-+-+-+-+-+ +
| |   |   |     |     |       | |
+ +-+ +-+ + +-+-+-+-+ + +-+-+ + +
|   |   |   |   |   | | | | |   |
+ + +-+ +-+ + + + + + + +-+-+-+-+
| |   |   |   |   |   |         |
+ +-+ +-+ +-+-+-+-+-+-+-+-+-+-+ +
|       |     |   |   | |   |   |
+ +-+-+ +-+ + + + + + + + + +-+ +
|           |   |   |     |     |
+-+-+-+-+-+-+-+-+-+-+-+-+-+-+-+-+
