+-+-+-+-+-+-+-+-+-+-+-+-+-+-+-+-+
|               |             | |
+-+ +-+-+-+-+ +-+ +-+-+-+-+-+ + +
| | | |     | | | |         | | |
+ + + + +-+ + + + + +-+-+-+ + + +
| | | | | | | | | | | |   | | | |
+-+ + + + + + +-+ + + + + + + + +
|   | | | | |     | | |   | | | |
+ + + + + + +-+-+ + + +-+-+ + + +
| | | | | |     | | |       | | |
+ + +-+ + + +-+ + + +-+-+-+ + + +
| |     | | | | | | |     | |   |
+ + +-+ + + + + +-+ + + + + +-+ +
| | | | | | | |     |     | | | |
+ + + + + + + +-+-+ + + + + + + +
| | | | | | | |G  | |     | | | |
+ + + + +-+ + + + + + + + + + + +
| | | |     | |   | |     | | | |
+-+ +-+ +-+-+ + +-+ + + + + +-+ +
| | |       |       |     |     |
+ + + +-+-+ +-+-+-+ +-+-+-+ +-+-+
| | | | | | |             | |   |
+ + + + + + +-+-+-+-+-+-+ + +-+ +
| | | | | |             | | | | |
+ + + + + + +-+-+-+-+-+-+ + +-+ +
| | | | | | |           | |     |
+ + + + + + +-+-+-+-+-+-+ +-+-+ +
|   | | | |                   | |
+ +-+ + + + +-+-+-+ +-+-+ +-+-+ +
| | | | | | |     |       |   | |
+ +-+ + +-+ +-+-+-+-+-+-+ +-+-+ +
|     |                 |       |
+-+-+-+-+-+-+-+-+-+-+-+-+-+-+-+-+
