+-+-+-+-+-+-+-+-+-+-+-+-+-+-+-+-+
|             |   |           | |
+-+-+-+ +-+-+ + + + +-+-+ +-+-+ +
| |         | | | | |         | |
+ + +-+-+-+ + + + + +-+-+-+-+ + +
| | |     | |   |   | |     | | |
+ + + +-+ + + + + + + + +-+ + + +
| |   | |   | | | | |   | | | | |
+ + + +-+ + + + + + + + +-+ + + +
| | |     |   | | | | |       | |
+ + +-+-+-+ + + + + + +-+-+-+ + +
| |       | | |   | | |       | |
+ +-+-+ +-+-+-+-+-+-+ +-+-+-+-+ +
|           |       |           |
+-+-+ +-+-+-+ +-+-+ +-+-+-+ +-+-+
|           | |G    |           |
+ +-+-+-+-+ + + + + + +-+-+-+-+ +
|           | |   | |           |
+-+-+ +-+-+-+ +-+-+ +-+-+-+ +-+-+
|           |       |           |
+-+-+-+ +-+-+-+-+-+ +-+-+ +-+-+ +
| |         | |   |           | |
+ + +-+-+-+ + + + + + +-+-+-+ + +
| |       | | | | | | |       | |
+ + + +-+ + + + + + + + +-+ + + +
| | | | | | |   | | |   | | | | |
+ + + +-+ + + + + + + + +-+ + + +
| | |       | | |   | |     |   |
+ + +-+-+-+ + + + + + + +-+-+ + +
|           | | | |   |       | |
+ +-+-+ +-+-+ + + + +-+-+-+-+-+ +
|             |   |             |
+-+-+-+-+-+-+-+-+-+-+-+-+-+-+-+-+
