+-+-+-+-+-+-+-+-+-+-+-+-+-+-+-+-+
|                               |
+-+-+-+-+-+ +-+-+-+-+ +-+-+-+-+ +
|                             | |
+ +-+-+-+-+-+-+-+-+-+-+-+-+-+ + +
| |                         | | |
+ + +-+-+ +-+-+ + +-+-+ +-+ + + +
| | | |   |     |     |   | | | |
+ + +-+ +-+ +-+-+-+-+ +-+ + + + +
| | |   |   |       |   |   | | |
+ + + +-+ +-+ +-+-+ +-+ +-+ + + +
| | | |   |       |   |   | |   |
+ + + + +-+ +-+ + + + +-+ + + + +
| | | | |   |   |   |   | | | | |
+ + + + + +-+ +-+-+ +-+ + + + + +
| | | | | |   |G  |   | | | | | |
+ + + + + + +-+ + +-+ + + + + + +
| | | | | |   |   |   | | | | | |
+ + + + + +-+ +-+ + +-+ + + + + +
| | | | |   |   |   |   | | | | |
+ + + + +-+ +-+ + +-+ +-+ + + + +
| | | |   |   |   |   |   | |   |
+ + + +-+ +-+ +-+-+ +-+ +-+ + + +
| | |   |   |   |   |   |   | | |
+ + + + +-+ +-+ + +-+ +-+ + + + +
| | | |   |           |   | | | |
+ + + +-+ +-+-+-+-+-+-+ +-+ + + +
| | |                       | | |
+ + +-+-+-+-+-+-+-+ +-+-+-+-+ + +
| |                           | |
+ +-+-+-+-+-+ +-+-+-+ +-+-+-+-+ +
|                               |
+-+-+-+-+-+-+-+-+-+-+-+-+-+-+-+-+
