+-+-+-+-+-+-+-+-+-+-+-+-+-+-+-+-+
|                 | | | | | |   |
+-+ + +-+ +-+ +-+ + + + + + + + +
|   |                         | |
+ +-+-+ +-+ + +-+-+ + + + + + + +
|     |     | |   | | | | | | | |
+-+ + + + +-+ + +-+-+-+-+-+-+ + +
|   | | |   |   | | |       | | |
+ +-+ + +-+ +-+-+ + + +-+-+ + + +
|   |             |   |   | | | |
+-+ +-+ +-+-+-+-+-+ +-+ + + + + +
|     |       |     |   | | | | |
+ +-+ +-+-+-+ + +-+-+ +-+ + + + +
| | |   |   | |       |   |   | |
+ + +-+ + + + +-+-+-+-+ + +-+-+ +
| |   |   |   |G  |     | |   | |
+ + + + +-+-+-+ + + +-+-+-+ + + +
|   |   |     |   |   |   | | | |
+-+-+ +-+ +-+ + +-+-+ + + + + + +
|     | |   | |     |   | | | | |
+ + + + +-+-+ + + +-+ +-+ + + + +
| | |         | |   |   |   | | |
+ + +-+ +-+-+-+ +-+ +-+ +-+-+ + +
| |   | |     |       |     | | |
+ +-+ + + +-+ + +-+-+ +-+-+ + + +
| |   |   |   |         |   | | |
+ + +-+-+-+ +-+-+-+ +-+ + + + + +
| |   |   | | |   |       | | | |
+ + + + + + + + + +-+-+-+ + + + +
| | | | |   |   |   |   | | | | |
+ + + + +-+-+ + + + + + +-+ + + +
|   |         |   |   |     |   |
+-+-+-+-+-+-+-+-+-+-+-+-+-+-+-+-+
