+-+-+-+-+-+-+-+-+-+-+-+-+-+-+-+-+
|                               |
+-+-+ +-+-+-+ +-+-+ +-+-+ +-+-+-+
|   | |                         |
+ +-+ + +-+-+-+-+-+-+-+-+-+-+ + +
|     | |     |               | |
+ +-+-+ +-+ + + + +-+-+-+-+-+-+ +
| |     |   |   | |       |     |
+ + +-+-+ + + + +-+ + + + + + + +
| | | |   |   | | | | | | | | | |
+ + + + +-+ + +-+ + + + + + + + +
| | |       | |           |     |
+ + + +-+ +-+-+-+ +-+ + + + + + +
|   |       |       | | | | | | |
+ + +-+ +-+-+-+-+-+ + + + + +-+-+
| | |     |   |G  | |     | |   |
+ + + +-+ + + + + + + + + + + + +
| | |     | | |     | | | | | | |
+ + +-+ +-+ + +-+-+-+-+-+ + + + +
|   |     |             | | | | |
+ + + +-+ + +-+-+ +-+-+ + + + + +
| | |     |             | | | | |
+ + +-+ +-+ +-+-+ +-+-+ + + + + +
| | |     |             | | | | |
+ + + + +-+ +-+-+ +-+-+ + + + + +
| | | |               |   |   | |
+ + + +-+-+-+-+-+-+-+-+-+-+-+-+ +
| | |                           |
+ + +-+-+-+-+-+-+-+-+-+-+-+ +-+ +
|   |               |     |     |
+-+ + +-+-+ +-+-+ +-+ +-+ +-+-+ +
|                       |       |
+-+-+-+-+-+-+-+-+-+-+-+-+-+-+-+-+
