+-+-+-+-+-+-+-+-+-+-+-+-+-+-+-+-+
|                               |
+-+-+ + +-+-+-+-+-+-+-+-+ + +-+-+
|     |                   |     |
+ +-+-+-+-+-+-+-+-+-+-+-+-+-+-+ +
| | |                       | | |
+ + + +-+-+-+-+ +-+-+-+-+-+ + + +
| | | |                   | | | |
+ + + + +-+-+-+ +-+-+-+-+ + + + +
|   | | | |             | | | | |
+ + + + + +-+-+ +-+-+-+ + + + + +
| | | | | |           | | | | | |
+ + + + + +-+-+-+-+-+ + +-+ + + +
| | | | | | | |     | | | | | | |
+ + + + + + + + +-+ + + + + + + +
| | | | | | | |G  | | | | |   | |
+ +-+ + + + + + + + +-+-+ + + + +
| |   |   |   |   | | | | | | | |
+ + + + + + + +-+-+ + + + + + + +
| | | | | | |       | | | | |   |
+ + + + + + +-+-+-+-+ + + + + + +
| | | | | |           | |   | | |
+ + + + + +-+-+ +-+-+-+ + +-+ + +
| | | | |               | |   | |
+ + + + +-+-+-+-+-+ +-+-+ + + + +
| | | |                 | | |   |
+ + +-+-+-+-+-+-+-+-+-+-+-+ + + +
| | |                       | | |
+ + +-+-+-+-+ +-+-+-+-+-+-+-+ + +
| |                           | |
+ + +-+-+ +-+-+-+-+-+ +-+-+-+-+ +
|                               |
+-+-+-+-+-+-+-+-+-+-+-+-+-+-+-+-+
