+-+-+-+-+-+-+-+-+-+-+-+-+-+-+-+-+
|       |     |       |         |
+-+-+-+ +-+-+ + +-+-+ +-+-+ + + +
| |   | |   | |     |     | | | |
+ + + + + + + + +-+-+ +-+-+ + + +
| | | | | | |   |     |     | | |
+ + + + + + + + +-+-+ +-+-+ + + +
|   |     | | |     |     | |   |
+ + +-+-+-+ + + +-+-+ +-+-+ + + +
| |         | | |     |     | | |
+ +-+-+ +-+ + + +-+-+ +-+-+ + + +
|             |     |       | | |
+-+-+ +-+ +-+-+-+-+-+-+-+-+-+ + +
|   | |     |       | |         |
+ +-+ +-+-+-+ +-+-+ + +-+-+ +-+ +
|           | |G  |       | |   |
+ + +-+ +-+ + + + + +-+ +-+ +-+ +
| | | | | | | |     | | |     | |
+ + + + + + + +-+-+ + + + +-+ + +
| | | | | | |       |   | | | | |
+ +-+ +-+ +-+-+-+-+ + + + +-+ + +
|           |   |   | | |     | |
+-+ +-+ +-+ +-+ + +-+-+ +-+-+-+ +
| | | | | | | |                 |
+ + + + + + + + +-+-+-+ +-+-+-+ +
| | | | | | | | |     | |       |
+ +-+ +-+ + + +-+ +-+ + + +-+-+ +
|           |     | | | |       |
+-+ +-+-+-+-+ + + +-+ + + +-+-+ +
|             | |     | | |   | |
+ +-+-+ +-+-+ + +-+-+-+ + +-+-+ +
|                               |
+-+-+-+-+-+-+-+-+-+-+-+-+-+-+-+-+
