+-+-+-+-+-+-+-+-+-+-+-+-+-+-+-+-+
|     | | | |         |         |
+-+ + + + + + +-+-+-+ + +-+ +-+ +
|   |         |       | |     | |
+ +-+ + + + + +-+ +-+-+ + +-+ + +
|   | | | | |   |       | |   | |
+-+ + +-+-+-+-+ +-+ +-+-+ + +-+ +
|   |         |   | |   | |   | |
+ +-+-+-+-+-+ +-+ +-+ + + +-+ + +
|   |           |     |   |   | |
+-+ + +-+-+-+-+-+-+-+-+-+-+ +-+ +
|     |                       | |
+ +-+ +-+ +-+-+-+-+-+-+-+-+-+ + +
| | |   | |       |         | | |
+ + + + + + + + +-+-+ +-+ +-+ + +
| |   | | | | |G  |   |     | | |
+ + +-+ + + + + + + +-+ +-+ + + +
| | |   | | | |   |   |     | | |
+ + + +-+ + + +-+-+-+ +-+ +-+ + +
| | |   | | | |     | |     | | |
+ + +-+ + + + +-+ + + + +-+ + + +
| | |     | |   | |   |     | | |
+ + + +-+ + + + + + +-+-+ +-+ + +
|         |   |   | |   |   | | |
+ + +-+ +-+ +-+-+ + + + +-+ + + +
| | |   |           | |   |   | |
+ + + +-+-+-+-+-+-+ + +-+ +-+ + +
|     |   |         |   |   | | |
+-+-+-+ + + +-+-+-+-+-+ +-+ + + +
|       |                 |   | |
+ +-+-+-+-+-+-+-+-+-+-+-+-+-+ + +
|                               |
+-+-+-+-+-+-+-+-+-+-+-+-+-+-+-+-+
