+-+-+-+-+-+-+-+-+-+-+-+-+-+-+-+-+
|           |                   |
+-+-+ +-+ +-+ +-+ + +-+ +-+ +-+ +
|     |           |   |       | |
+ +-+ + +-+-+ +-+ +-+ +-+ +-+ + +
| |     |           |   |   |   |
+ + +-+ + +-+-+-+-+-+-+ +-+ + + +
|   |     |           |   |   | |
+ +-+ + + +-+ + +-+ +-+-+ +-+ +-+
| |   | | |   |       | |   |   |
+ + +-+ + +-+ + +-+ +-+ +-+ +-+ +
| |   |     | | |     |   |   | |
+ +-+ +-+-+ + + +-+ +-+ + +-+ + +
|   |   |   | | |     | | | |   |
+ + + + + +-+ + +-+ +-+ + + +-+ +
| | | | |   | |G  |   | | |   | |
+-+ +-+ +-+ + + + + + + + + + + +
| | | | |   | |   | | | | | | | |
+ + + + + +-+ +-+-+-+ + + + + + +
|   |       |   |   | | | | | | |
+ +-+ +-+-+ + + + + + + + + + + +
| |   |     | |   | | | | | | | |
+ + +-+ +-+-+-+-+-+ + + + + + + +
| |   |   |         |   | | | | |
+ +-+ + + + +-+-+-+-+-+ + + + + +
|   |   | |           | |   | | |
+ + + + + +-+-+-+-+-+ +-+-+-+ + +
| | | |     |   |   |       |   |
+-+ + + + + + + + + +-+-+-+ +-+ +
| | |   | |   |   |             |
+ + +-+-+ +-+-+-+-+-+-+-+-+-+-+ +
|                               |
+-+-+-+-+-+-+-+-+-+-+-+-+-+-+-+-+
