+-+-+-+-+-+-+-+-+-+-+-+-+-+-+-+-+
|       |                       |
+-+-+-+ + +-+-+ +-+-+-+-+ +-+-+ +
| |   | | |   | | |     | |   | |
+ + + + + + + + +-+ +-+ + + + + +
| |   | | |   |     | | | |   | |
+ + + + + + + + +-+ + + + + + + +
| |   | | |   | | | | | | |   | |
+ +-+-+ + + + + +-+ +-+ + +-+-+ +
|       | |   | |       |       |
+ + +-+-+ +-+-+ + +-+-+-+ +-+-+ +
| | |   |       | |           | |
+ + + + + +-+-+-+ + +-+-+-+-+ + +
| | |   | | |     |           | |
+ + +-+-+ +-+ +-+-+ +-+-+-+-+-+ +
| |           |G  |             |
+ + +-+-+-+-+ + + +-+-+-+ +-+-+ +
| |           |                 |
+ + +-+-+ +-+ +-+-+-+-+-+-+-+-+ +
| | |   | | |       |   |   | | |
+ + + + + +-+-+-+-+ + + + + + + +
| | |   |         | |   | | | | |
+ + +-+-+ +-+-+ + + +-+-+ + +-+ +
|         |   | | |     | |     |
+ +-+-+ + + + + + +-+-+ + + +-+ +
| |   | | |   | |     | | | | | |
+ + + + + + + + +-+-+ + + + + + +
| |   | | |   |     | | | | | | |
+ + + + + + + + +-+ + + + + + + +
| |   | | |   | | | |   | | | | |
+ +-+-+ + +-+-+ +-+ +-+-+ + +-+ +
|       |                       |
+-+-+-+-+-+-+-+-+-+-+-+-+-+-+-+-+
