+-+-+-+-+-+-+-+-+-+-+-+-+-+-+-+-+
|             | | | | | | |     |
+-+-+-+ +-+-+ +-+-+-+-+-+ +-+-+-+
|     | | | |       |           |
+-+-+-+ +-+-+-+-+-+ + +-+-+-+ + +
|     | |       | | | |     | | |
+-+-+-+ + +-+-+ + + + +-+-+ + + +
|       |     | | |   |   | | | |
+ +-+ + + +-+-+ + + +-+-+ + + + +
| | | | | |     | | | | | | | | |
+ +-+ + + + +-+-+-+ + +-+-+-+ + +
|   | | | | |   | | |   | |   | |
+-+ + + + + +-+ +-+ +-+-+ + +-+ +
| | |   | | | |           | |   |
+ + + +-+ + + +-+-+-+-+-+-+ + +-+
| | |     | | |G  |         | | |
+ + +-+-+-+ +-+ + + +-+-+-+-+ + +
| | | |   | | |   |         | | |
+ + + +-+ + + + +-+-+-+-+-+ + +-+
| | |   | | | |           | |   |
+-+ + + + + +-+ +-+ +-+-+ + +-+ +
|   | | | | |   | | |   |     | |
+ +-+ + + + +-+-+-+ + +-+-+-+ + +
| | | | | |     | | | | | | | | |
+ +-+ + + +-+-+ + + +-+-+ + + + +
|     | |     | | |   |   | | | |
+-+-+-+ +-+-+-+ + + + +-+-+ + + +
|     |         | | | |     | | |
+-+-+-+ +-+-+-+ +-+ + +-+-+-+ + +
|     | | | |       |           |
+-+-+-+ +-+-+ +-+-+-+-+-+ +-+-+-+
|     |       | | | | | | |     |
+-+-+-+-+-+-+-+-+-+-+-+-+-+-+-+-+
