+-+-+-+-+-+-+-+-+-+-+-+-+-+-+-+-+
|                 |         |   |
+-+-+-+-+-+ +-+-+-+ +-+-+-+-+ + +
|         |                   | |
+ +-+ +-+ +-+-+ +-+-+-+ +-+-+-+ +
| | | |   |             |     | |
+ + + + +-+-+-+-+-+-+-+-+-+-+ + +
| | | |                         |
+ + +-+-+-+-+-+-+-+-+-+-+-+-+ + +
| | |           |           | | |
+ + + +-+-+-+-+ +-+ +-+-+ + + + +
| | | | | | |   |         | | | |
+ + + + + + + +-+ +-+-+-+ + + + +
|     | | | |       |   | | | | |
+ +-+-+ + + +-+-+-+-+ + + + + + +
|       | | | |G  | | | | | |   |
+ + +-+-+ + + + + + + + + + +-+-+
| | |   | | | |     | |     |   |
+ + + + + + + +-+-+ + +-+-+-+ + +
| | | | | | |       |         | |
+ + + + + + + +-+-+-+-+ +-+-+-+ +
|   | |   |       |   |       | |
+-+-+-+-+ +-+-+-+ + + +-+-+-+ + +
|       | |     |   |   |       |
+ +-+-+ + + +-+-+-+ +-+ + +-+-+ +
| |       | |     |   |         |
+ + +-+-+-+ + + +-+-+ +-+ +-+ + +
| |         | | |       |   | | |
+ +-+-+-+-+-+ + + +-+-+ +-+ + + +
|             | |         |   | |
+ +-+-+-+-+-+ + +-+-+-+-+ +-+ + +
|             |                 |
+-+-+-+-+-+-+-+-+-+-+-+-+-+-+-+-+
