+-+-+-+-+-+-+-+-+-+-+-+-+-+-+-+-+
|         |   |                 |
+-+-+ +-+ +-+-+ +-+-+-+ +-+-+-+ +
|   | | |       |     | | | | | |
+ + + + + +-+-+ + + +-+ +-+ + + +
|   | | | |   | |   |       | | |
+-+-+ +-+-+-+-+ + + + +-+-+ + + +
|               |   | |     | | |
+ + +-+ +-+-+-+ +-+-+ + +-+ + + +
| | | | |     |       | | | | | |
+ + + + + + + + +-+-+-+ + + +-+ +
| | | | |     | |     | | |     |
+ + + + + + +-+ + + + + + + +-+ +
| | | | |   |   |     | | | | | |
+ + +-+ +-+-+ +-+-+ + + +-+ + + +
| |           |G  |   |     | | |
+ + +-+-+ +-+-+ + +-+-+-+-+-+-+ +
|   |   | |   |   |       |     |
+ +-+ + + + + +-+ + +-+ +-+-+-+ +
| |     | |     | | | | |     | |
+ + +-+-+ + + + + + + + + + +-+ +
| | |     |     |   | | |   |   |
+ +-+ +-+-+-+-+-+ + +-+ +-+-+-+ +
|     |         | | |         | |
+ +-+ + +-+-+-+ + + + +-+-+-+ + +
| | | | |     | | | |       | | |
+ +-+ + +-+-+-+ +-+ + +-+-+ + + +
| |             | |   |   | |   |
+ +-+-+-+-+ +-+-+ + +-+ + + + +-+
| |       | |   | | | |   | | | |
+ +-+-+-+-+ +-+-+ +-+ +-+-+ + +-+
|                               |
+-+-+-+-+-+-+-+-+-+-+-+-+-+-+-+-+
