+-+-+-+-+-+-+-+-+-+-+-+-+-+-+-+-+
|         | | |                 |
+-+ +-+-+ + + + + +-+ +-+ +-+-+ +
|       | | | | |   |   |   | | |
+ +-+ + + + + + +-+ +-+ +-+ +-+ +
| | | | |   | | | |   |   |   | |
+ + + + + + + + +-+-+ +-+ +-+ + +
| | |   | |   |     |   |   |   |
+ + + +-+ + + +-+-+ +-+ +-+ +-+ +
| |       | |     | | |   |   | |
+ + +-+ + + + +-+ + +-+-+ +-+ + +
| | | | | | |     |     | | |   |
+ + +-+ + + + +-+-+-+-+ + + +-+ +
| |     |   | |           |     |
+ + +-+ +-+ + + +-+ +-+-+-+ +-+ +
| | |     |   |G  | | | | | | | |
+ + + + + +-+ + + +-+ + + + + + +
| | | | |   | |   |             |
+ + + + +-+ +-+-+-+ + + + + + + +
| | | | | |   |     | | | | | | |
+ + + + +-+-+ +-+-+ + +-+-+-+-+ +
| | | |     |   |         |   | |
+ + + +-+-+ +-+ +-+ +-+ + + + + +
| | |     | | |   |   | |   |   |
+ + + +-+ + +-+-+ +-+-+ + + + + +
| | | | | |             | |   | |
+ + + +-+ +-+-+-+ +-+-+ + + + + +
| | |             |   | |   | | |
+ + +-+-+-+-+-+-+-+ + + + + + + +
| |                 | |   | |   |
+ +-+-+-+-+-+-+-+-+-+ + +-+ + +-+
|                             | |
+-+-+-+-+-+-+-+-+-+-+-+-+-+-+-+-+
