+-+-+-+-+-+-+-+-+-+-+-+-+-+-+-+-+
|                               |
+-+ +-+-+-+-+-+-+-+-+-+-+-+-+-+ +
|   |       |                 | |
+ +-+ +-+-+ + +-+-+-+-+-+-+ +-+ +
| |     |   |             |     |
+ + +-+-+-+ +-+-+-+-+ +-+ +-+-+-+
| | | |   |       |     |   |   |
+ + + + +-+ +-+-+-+-+-+ +-+-+ + +
| | |   |   |         |   |   | |
+ + + +-+ +-+ +-+-+-+ +-+ +-+ + +
| |   |   |   |         |     | |
+ + +-+ +-+ +-+ +-+-+-+ +-+-+ + +
| | |   |   |   |   | |     | | |
+ + + +-+ +-+ +-+ + + +-+-+ +-+ +
| | | |   |   |G  |           | |
+ + + + +-+ + + + + +-+-+ +-+ + +
|   | |   |   |   |           | |
+ + + +-+ +-+ +-+ + + +-+ + + + +
| | |   |   |   |   | |   | | | |
+ + +-+ +-+ +-+ +-+-+-+ +-+-+ + +
| | | |   |   |         |   | | |
+ +-+ +-+ +-+ +-+-+-+ +-+ + + + +
| | | | |   |     |   |   | | | |
+ + + + +-+ +-+-+ +-+ + +-+ + + +
| |   |   |       |     |   | | |
+ + + + + +-+-+-+-+-+-+-+ + + + +
| | | | | |               | | | |
+ + + + + + +-+-+-+-+-+-+-+-+ + +
| | | | | |           |       | |
+ + + + + +-+-+-+-+-+ + +-+-+-+ +
|   |   |             |         |
+-+-+-+-+-+-+-+-+-+-+-+-+-+-+-+-+
