+-+-+-+-+-+-+-+-+-+-+-+-+-+-+-+-+
|       |     |   |           | |
+-+-+-+ +-+-+ +-+-+ +-+-+-+-+ +-+
| |   | |               | | |   |
+ +-+-+ + +-+-+-+-+-+-+ +-+-+-+ +
|       | | | | | | | |         |
+ +-+-+-+ +-+ + + + +-+-+-+-+-+ +
| |         |   |   |         | |
+ + +-+-+-+ +-+ + +-+ +-+-+-+ + +
| | |     |   | | |   |     | | |
+ +-+ +-+ +-+ + + +-+-+ +-+ +-+ +
| |   | |   | |   | |   | |   | |
+ +-+ +-+ +-+ +-+-+ + + +-+ +-+ +
| | |     |   |     | |     | | |
+ + +-+-+-+ + + +-+ + +-+-+-+ + +
|           | |G  | |           |
+ +-+-+-+-+-+ + + + +-+-+-+-+-+ +
|             |   |             |
+-+-+-+ + +-+-+-+-+-+-+ + +-+-+-+
|       | |     |     | |       |
+-+ +-+-+ + +-+ + +-+ + +-+-+ +-+
| | |   | | | | | | | |   | | | |
+ + + + + +-+-+-+-+-+-+ + +-+ + +
| | |   |               |   | | |
+ + +-+-+-+-+ +-+-+ +-+ +-+ + + +
| |           |   |         | | |
+ + + + +-+-+-+-+-+-+-+-+-+ + + +
| | | | |   |           | | | | |
+ + + +-+-+-+ +-+-+ +-+-+-+ + + +
| | | | |               | | | | |
+ + + +-+ +-+-+-+-+-+-+ +-+ + + +
| |       |           |       | |
+-+-+-+-+-+-+-+-+-+-+-+-+-+-+-+-+
