+-+-+-+-+-+-+-+-+-+-+-+-+-+-+-+-+
|                               |
+-+-+ +-+-+ +-+-+-+-+ +-+-+-+-+ +
| | | |   |     |   |   | |     |
+-+-+ + + + +-+ +-+ +-+ +-+ +-+-+
|     | | | | | | |   |   |     |
+ +-+-+ + +-+ + + +-+ +-+ +-+-+ +
| |     |           |   |   | | |
+ + +-+ + +-+-+-+-+ + + +-+ +-+ +
| | | |   |         | | | |     |
+ +-+ + + + +-+-+-+ + + + + +-+ +
|     | | |         | |   | | | |
+ +-+ + + + +-+-+-+-+ + + + +-+ +
| | | | | |           | | |     |
+ +-+ + + + +-+-+-+-+-+ + +-+-+ +
|       |   | |G  |     |     | |
+ +-+-+-+ +-+ + + + +-+-+ +-+ + +
| |     |     |   | | | | | | | |
+ + +-+-+ +-+-+ +-+-+ + + + +-+ +
| | | | | |     |   |   | |     |
+ +-+ + + + + +-+ + + + + + +-+-+
|       | | | | | | | | | |     |
+ +-+-+ + + + +-+ + + + + + +-+ +
| |   |   |   | | |   | | | | | |
+ + + +-+-+-+ +-+ +-+-+ + +-+ + +
| | | | |   |     |     |     | |
+ + + + +-+ +-+-+ + +-+ + +-+-+ +
| | | |         | | | | | |   | |
+ + + + +-+-+-+ + +-+ + + + + + +
| | | |       | |     |   | | | |
+ + + +-+-+-+ + +-+-+ +-+-+ + + +
|   |         |             |   |
+-+-+-+-+-+-+-+-+-+-+-+-+-+-+-+-+
