+-+-+-+-+-+-+-+-+-+-+-+-+-+-+-+-+
|                 | |           |
+-+-+-+ +-+-+-+-+ + + +-+-+ +-+ +
|                 | | |     | | |
+ + +-+-+-+ +-+ + +-+ + +-+ +-+ +
| | |     | | | |     | | |   | |
+ + + +-+-+ + + +-+-+-+ +-+-+ + +
| | | |     | | |   |   |   |   |
+ + +-+ +-+-+-+ +-+-+ +-+ + +-+ +
| |     |     |       |   |   | |
+ + +-+-+ +-+ +-+ +-+-+ +-+-+ + +
|         | | | | |     |   | | |
+ +-+-+-+ +-+ +-+-+ +-+-+-+-+ + +
|                               |
+-+-+ +-+-+-+-+-+-+-+-+-+-+ +-+-+
| | | |       |G  |       | | | |
+-+-+ + +-+-+ + + + +-+-+ + +-+-+
| |   | |   | |   | |   | |   | |
+-+ +-+ +-+-+ +-+ + +-+-+ +-+ +-+
|   |   |   | |   | |   |   |   |
+ +-+ +-+-+-+ + +-+ +-+-+-+ +-+ +
| |   |       | | |       |   | |
+ + +-+ +-+-+-+ +-+-+-+-+ +-+ + +
| |     |     |         |     | |
+ + +-+-+ +-+-+-+ +-+-+ +-+-+ + +
|   |   | |           |     |   |
+ +-+ + +-+ +-+-+-+-+ +-+-+ +-+ +
|     | |           |     |     |
+ +-+-+ +-+-+-+-+-+ +-+-+ +-+-+ +
|       |   |       |   |       |
+ +-+-+-+-+-+ +-+-+ +-+-+-+-+-+ +
|             |   |             |
+-+-+-+-+-+-+-+-+-+-+-+-+-+-+-+-+
