+-+-+-+-+-+-+-+-+-+-+-+-+-+-+-+-+
|       |                       |
+-+-+-+ + +-+-+-+ +-+-+-+ +-+-+ +
|       | |     | |         | | |
+ +-+-+-+ +-+-+-+ +-+-+ +-+ + + +
| |   |       |         | | | | |
+ +-+-+ +-+-+ +-+-+ +-+-+-+ +-+ +
| |   | |   |       |   | |     |
+ +-+-+ +-+-+ +-+-+-+-+-+ +-+-+ +
| |   | |     |   |       |   | |
+ +-+-+ +-+-+ + + + +-+-+ + + + +
| |   | |   | |   | |   | |   | |
+ +-+-+ + + + +-+-+ + + + +-+-+ +
|       |   | |     |   |       |
+ +-+-+ +-+-+ +-+-+ +-+-+-+-+-+ +
| |   |       |G          |   | |
+ + + + +-+-+-+ + +-+-+-+ + + +-+
| |   | |   | |   | |   | |   | |
+ +-+-+ + + + +-+-+ + + + +-+-+ +
|       |   | |     |   |       |
+ +-+-+ +-+-+ +-+-+ +-+-+-+-+-+ +
| |   |       |   |       |   | |
+ +-+-+ +-+-+ + + + +-+-+ + + + +
| |   | |   | |   | |   | |   | |
+ +-+-+ +-+-+ +-+-+ + + + +-+-+ +
| |   |             |   |     | |
+ +-+-+ +-+-+-+-+ +-+-+-+ +-+ + +
| |   | |       | |       | | | |
+ +-+-+ +-+-+-+-+ + +-+-+-+ + + +
|                 | |       | | |
+-+-+-+-+-+ +-+-+-+ +-+-+-+-+ + +
|                               |
+-+-+-+-+-+-+-+-+-+-+-+-+-+-+-+-+
