+-+-+-+-+-+-+-+-+-+-+-+-+-+-+-+-+
|           | |         |       |
+-+-+ +-+-+ + + +-+-+ + + +-+ + +
|                     | |   | | |
+ +-+-+ + + + +-+-+-+ + +-+ + + +
| | | | | | | |     | | |   | | |
+ + +-+ + + + + +-+ + + + + + + +
| |     | | | | | | | | | | | | |
+ + +-+-+ + + + + + + + + + +-+ +
|           | |   | | | |   |   |
+-+ +-+-+ +-+ +-+-+ + + + +-+ + +
|         | |       | |   |   | |
+-+ +-+-+-+-+-+-+-+-+ + +-+ +-+ +
|           |         | |   |   |
+ + +-+-+-+ + +-+-+-+-+-+ +-+ +-+
| | |     | | |G  | | |   |     |
+ + + +-+ + + + + + + + +-+ +-+ +
| | | |   | | |   | | |   |     |
+ + + +-+-+ + +-+ + + +-+ +-+ +-+
| | |       | |         |   |   |
+ + +-+-+-+-+ +-+-+ + + +-+ +-+ +
|             |     | |   |   | |
+ +-+-+-+-+-+-+-+-+ + +-+ +-+ + +
|             |   |         |   |
+-+ +-+-+-+ +-+ + +-+ +-+ + +-+ +
|           |   |   |   | |   | |
+ +-+ +-+ +-+ +-+-+ +-+ + + + + +
| |   |   |   |   |   |   | |   |
+ + +-+ +-+ +-+ + +-+ +-+ + +-+ +
|       |   |   |   |   |       |
+ +-+ +-+ + + + + + +-+ +-+-+-+ +
|         |   |   |             |
+-+-+-+-+-+-+-+-+-+-+-+-+-+-+-+-+
