+-+-+-+-+-+-+-+-+-+-+-+-+-+-+-+-+
|     |   |                     |
+-+-+ + + + +-+ + +-+ +-+ +-+-+ +
|     | | | |   |   |   | |     |
+ +-+-+ + + + + +-+ +-+ + + +-+-+
|       | |   |   |   | | |     |
+-+-+ +-+ + +-+ + + + + + +-+-+ +
|     | | | |   | | |   |     | |
+ +-+-+ + + + +-+ + +-+ +-+-+ + +
|                     |       | |
+ +-+ +-+-+-+-+-+-+-+-+-+-+ +-+ +
| | | |                   |   | |
+ + + + +-+ +-+-+-+-+-+-+ + + + +
| |   |                 | | |   |
+ + +-+ +-+-+-+-+-+ +-+ + +-+-+ +
| | |          G        | |   | |
+ + + +-+ +-+ + + +-+ + + + + + +
| | | |       |   |   | | | | | |
+ + + + +-+-+-+-+-+-+-+ + + + + +
| | |       |           | | | | |
+ + +-+-+ + + +-+-+-+-+-+ + + + +
| |     | | |       |   | | | | |
+ +-+-+ + + +-+ +-+ + + + + + + +
| |     |     |   |   |     |   |
+ + +-+-+-+-+ +-+ +-+-+-+-+-+-+-+
| |       | |   |       |       |
+ +-+-+-+ + + + + + +-+ + +-+-+ +
| |     |   | |   |   | | |     |
+ + + + +-+ +-+ + + + + + + +-+-+
| | | |       | |   |     |     |
+ + + +-+-+-+ +-+-+-+-+-+-+-+-+ +
|   |                           |
+-+-+-+-+-+-+-+-+-+-+-+-+-+-+-+-+
