+-+-+-+-+-+-+-+-+-+-+-+-+-+-+-+-+
|   |   | |   |             |   |
+-+ + + + + + + + + + +-+-+-+ + +
|     |   | | | | | | | | | | | |
+ +-+ +-+ + + + + + + + + + + + +
|   |   |   | | | | |   | | | | |
+-+ +-+ +-+ + + + +-+-+ + + + + +
|     |   |   | | |   | | |   | |
+-+-+ +-+ +-+ + + + + + + + + + +
|       |   |   | | | |   | | | |
+ +-+-+ +-+ +-+ + + + + + + + + +
|         |   | | | | | | | | | |
+-+-+-+-+ +-+-+ + + + + + + + + +
|               | | | | |   | | |
+ +-+-+-+-+-+-+-+-+ + +-+-+ + + +
|           |  G  | |     | | | |
+ +-+-+-+-+-+ + + + +-+ +-+-+-+ +
|           | |   | |   |     | |
+ +-+ +-+-+-+ +-+-+ + +-+ + + + +
| |         |     | |   | | | | |
+ +-+-+-+ +-+-+-+ + +-+ + + + + +
| |           | |   |   | | | | |
+ +-+-+-+-+-+ + + + + +-+ + + + +
| |           | | | |     | | | |
+-+-+-+ +-+-+-+ +-+ +-+-+ + + + +
|         |   |   | |         | |
+ +-+-+-+-+ + + + + +-+ + +-+ + +
|       |   |   |     | | |     |
+ +-+-+ + +-+-+-+-+-+-+ + +-+-+ +
|       |               |     | |
+ +-+-+ +-+-+-+-+-+-+-+-+-+ +-+ +
|                               |
+-+-+-+-+-+-+-+-+-+-+-+-+-+-+-+-+
