+-+-+-+-+-+-+-+-+-+-+-+-+-+-+-+-+
|     |                         |
+-+-+ + +-+-+-+ +-+-+ +-+-+ +-+ +
|   | |       |       |     |   |
+ + + + + +-+ +-+-+-+-+ +-+-+ + +
|   | | | |                 | | |
+-+-+ + + +-+-+-+-+-+-+-+-+ + + +
|     | |     |   |   |   | | | |
+ +-+-+ + +-+ + + + + + + + + + +
| | |   | | | | | | | | | | | | |
+ +-+ + + +-+ + + + + + + + + + +
| | | | |   |   |   | | | | | | |
+ +-+ + +-+ +-+-+-+-+ + + + + + +
|   | |   | |       | | |   |   |
+ +-+ + + + + +-+-+ + + +-+-+-+ +
| |   | | | |  G  |         | | |
+ +-+ + + + + + + +-+-+-+-+-+-+ +
| | | | | | | |   |         | | |
+ +-+ + + + + +-+-+ + + + + +-+ +
|     |   | |       | | | |     |
+ +-+ + +-+ +-+-+-+-+ + + +-+-+ +
| | | | |   |   |   | | |       |
+ +-+ + + +-+ + + + + + +-+-+-+ +
| | |   | | | | | | | | |     | |
+ +-+-+ + +-+ + + + + + + +-+ + +
|     | |     |   |   |   | | | |
+ +-+ + + +-+-+-+-+-+-+-+-+-+ + +
| | | | |   |                   |
+ + + + +-+ + +-+-+ +-+-+-+-+-+ +
| | |       |     | |         | |
+ +-+ +-+-+-+-+-+ + +-+-+-+-+-+ +
|                 |             |
+-+-+-+-+-+-+-+-+-+-+-+-+-+-+-+-+
