+-+-+-+-+-+-+-+-+-+-+-+-+-+-+-+-+
|             |           |     |
+-+ +-+ +-+-+-+ +-+-+-+-+-+ +-+ +
|     |     |     |           | |
+ +-+ +-+ +-+ + +-+ +-+-+ +-+-+ +
| |     |     | |     |       | |
+ + +-+ +-+ +-+ + +-+-+ + +-+-+ +
|   |         |     |   |   |   |
+ + + +-+-+-+ + +-+ + +-+ + + + +
| |               |   | | | | | |
+ + +-+ +-+-+-+-+-+-+ + +-+ +-+ +
| |     | |         |       |   |
+ +-+-+-+ + +-+-+ + +-+-+-+-+-+ +
|         |       |   |         |
+ +-+ +-+-+ +-+-+-+ + + +-+-+ + +
|   |     |    G  | | |       | |
+ + +-+-+-+-+ + + + + + +-+ +-+ +
| |       |   |   | | |       | |
+ +-+ +-+ + +-+-+-+ + + +-+-+ + +
|   |   | |   |   | | |   |   | |
+ + +-+-+-+-+ + + + + +-+ + +-+-+
| |         |   |       |       |
+ + +-+ +-+-+-+-+-+ +-+ +-+ +-+ +
|     |     |   | |       | |   |
+ +-+-+-+-+ + + + +-+ +-+ + +-+ +
|   |   | |   |     |         | |
+ + + + + +-+-+-+-+ +-+-+-+ +-+ +
| |   |   |       |     | |   | |
+ +-+-+-+ + +-+ + +-+-+ + +-+ + +
|     | | |     | | | | | | |   |
+ + +-+ + + +-+ + + + + + + +-+ +
| |         | |                 |
+-+-+-+-+-+-+-+-+-+-+-+-+-+-+-+-+
