+-+-+-+-+-+-+-+-+-+-+-+-+-+-+-+-+
|     | |     |   |             |
+-+-+ + + +-+ + + + +-+ +-+-+-+ +
| | | | | | | |   | | | |     | |
+ +-+ +-+ + + +-+-+ + + +-+-+ + +
|   |     | |       | |     | | |
+-+-+ +-+-+ + +-+ + + +-+-+ + + +
|   | |     | | | | |     | | | |
+-+-+ + +-+-+ + + + +-+-+ + +-+ +
|     | |     | | |     | |     |
+ +-+-+ + +-+-+ + +-+-+ + +-+-+ +
| |     | |     |     | |     | |
+ +-+-+-+ + +-+-+-+-+ + +-+-+-+ +
|         | |       | |   |     |
+-+-+ +-+-+ + +-+-+ + +-+ + +-+ +
|   | |     |  G  | | | | | | | |
+ + + +-+-+-+ + + + + +-+ + + + +
|   |       | |   | |       | | |
+-+-+ +-+-+ + +-+-+ +-+-+-+-+-+ +
|         | |                   |
+ +-+-+-+ + +-+-+ +-+-+ +-+-+-+ +
| |     | |     | |   | |     | |
+ +-+-+ + +-+-+ + +-+-+ + +-+-+ +
|     | |     | |       | |     |
+ +-+ + +-+-+ + +-+ +-+-+ + +-+ +
| | | |     |     | |     | | | |
+ + + +-+-+ +-+-+ + + +-+-+ + + +
| | |     | | | | | | |     | | |
+ + +-+-+ + + +-+ + + + +-+-+ + +
| |     | | |     | | | |     | |
+ +-+-+-+ +-+ +-+-+ +-+ +-+-+-+ +
|                               |
+-+-+-+-+-+-+-+-+-+-+-+-+-+-+-+-+
