+-+-+-+-+-+-+-+-+-+-+-+-+-+-+-+-+
|             |                 |
+-+ +-+-+-+ +-+-+-+ +-+-+-+ +-+ +
| | |     |       |       |   | |
+ + +-+-+ +-+-+-+ + +-+-+ +-+ + +
|   |           | |     |   |   |
+ + + +-+-+-+ +-+ +-+-+ +-+ +-+ +
| | | |         |   | | | |     |
+ + + + +-+-+-+-+-+ +-+ +-+-+ + +
| |   | |         |   |     | | |
+ +-+ + + +-+-+-+ +-+ +-+-+ + + +
|   | | | |         |   | | | | |
+ + + + + + +-+-+-+-+-+ +-+ + + +
| | | |   | |         |   | |   |
+ + + +-+-+ + +-+-+ + +-+ + +-+ +
| | | |   | |  G  | |   |   |   |
+ + +-+ + + + + + + + + + +-+ + +
| | |   |   | |   | | | | | | | |
+ + + + +-+ + +-+-+ + + +-+ + +-+
|   | |   | |       | |   | | | |
+ + + +-+ +-+ +-+ +-+ + + + + + +
| | | | |   |           |   |   |
+ + + +-+-+ +-+ +-+ +-+ + + +-+ +
|   |     |   |         | |   | |
+ + +-+-+ +-+ +-+-+ + +-+ + + + +
| |     | | |     | |     | | | |
+ +-+-+ + +-+-+-+ +-+-+ +-+ + + +
|   | | |       |     |     |   |
+ + +-+ +-+-+-+ +-+ +-+-+ +-+ + +
| |   |           |   |       | |
+ +-+ +-+-+-+-+ +-+-+ + +-+ +-+ +
|                   |           |
+-+-+-+-+-+-+-+-+-+-+-+-+-+-+-+-+
