+-+-+-+-+-+-+-+-+-+-+-+-+-+-+-+-+
|       |   |     |             |
+-+-+-+ +-+-+ +-+ + +-+ +-+-+-+ +
|   | |       | |   | | |   |   |
+ + +-+-+-+-+-+-+ + +-+-+-+-+ + +
| |               |           | |
+ +-+-+-+-+ + +-+-+ + +-+-+-+-+ +
| |         | |   | |         | |
+ + +-+-+ + + + +-+ +-+ +-+-+ + +
| |       | | | | | | |       | |
+ +-+-+ +-+ + +-+-+ +-+-+ +-+-+ +
| | |       |               | | |
+ + + +-+-+-+-+-+-+-+-+-+-+ + + +
| | | |   |     |     |   | | | |
+ +-+ + + + + +-+-+ + + + + +-+ +
|   | | | | | |G  | | | | | |   |
+-+ + + + + + + + + + + + + + +-+
| | |   | | | |   | | | |   | | |
+-+ + +-+ + +-+ +-+-+ + +-+ + +-+
|   | | |   | | | | |   | | |   |
+ + + +-+ +-+ + +-+ +-+ +-+-+-+ +
| | | |   | | |   | | |         |
+ + + + +-+ + + + + + +-+ +-+ + +
| |       | | | | | | |   | | | |
+ +-+-+-+ +-+-+ + +-+-+ +-+-+ + +
|   |   | |   | | | | | |   |   |
+ +-+ + + + + + + + + + + + +-+ +
| | | | | | | |   |   | | | | | |
+ +-+ + + + + + + + + + + + +-+ +
|     |   | | | | | | |   |     |
+ +-+ +-+-+ + + + + + +-+-+ +-+ +
|           |   |   |           |
+-+-+-+-+-+-+-+-+-+-+-+-+-+-+-+-+
