+-+-+-+-+-+-+-+-+-+-+-+-+-+-+-+-+
|     |                         |
+-+-+ +-+-+-+-+-+-+ +-+-+-+-+ +-+
|     |                     | | |
+ +-+-+ +-+-+ +-+-+-+-+-+-+ + + +
| |     |                 |   | |
+ + + +-+-+-+-+-+-+-+-+-+ +-+ +-+
| | | |                 |   |   |
+ + + + +-+-+-+-+-+-+-+ +-+ +-+ +
| | | | |       |     |   |   | |
+ + + + + +-+-+-+ +-+ +-+ +-+ + +
| | | | | |       |     |   | | |
+ + + + + + +-+-+ +-+-+ +-+-+ + +
| |   | | | |       | |       | |
+ + +-+-+ +-+ +-+-+ +-+-+-+-+-+ +
| |         |  G  |             |
+ + +-+-+-+-+ + + + +-+-+-+-+-+ +
|           | |   |             |
+ +-+-+-+ +-+ +-+-+ +-+-+-+-+ + +
| |   | | | |       | |       | |
+ + + + + + +-+-+-+-+-+ +-+-+ + +
| | | | | |       |     |   | | |
+ + + + + +-+-+-+ +-+ +-+ +-+ + +
| | | | |       |     |   |   | |
+ + + + +-+-+-+-+-+-+-+ +-+ +-+ +
| | | |                 |   |   |
+ + + +-+-+-+-+-+-+-+-+-+ +-+ +-+
| |                       |   | |
+ +-+-+ +-+ +-+-+-+-+ +-+-+ + + +
|     | | | |               | | |
+-+-+ + +-+ +-+-+ +-+-+-+-+-+ +-+
|                               |
+-+-+-+-+-+-+-+-+-+-+-+-+-+-+-+-+
