+-+-+-+-+-+-+-+-+-+-+-+-+-+-+-+-+
|     | | |                     |
+-+-+ + +-+ +-+-+-+ +-+-+ +-+-+ +
|   | |     | |     |   | |   | |
+-+-+ + +-+ +-+ +-+-+ +-+ + + + +
|     | | |     |   | | | | | | |
+ +-+-+ +-+ +-+-+-+-+ +-+ + + + +
| |         |   |     |   | |   |
+ + + +-+-+ +-+-+ +-+-+-+ + + +-+
| | | |   |       |         | | |
+ + + +-+ + + +-+-+ +-+-+-+-+ + +
| | | |   | | |     |     |   | |
+ + + +-+ +-+ + +-+-+ +-+ +-+ +-+
| | |   |   | | | |         |   |
+ + +-+ +-+ +-+-+-+ +-+-+-+ +-+ +
| |       |   |G  | |           |
+ + +-+-+-+-+-+ + + + +-+-+-+-+-+
|         |   |     |           |
+ +-+-+ +-+ +-+-+-+ +-+-+-+ +-+ +
| |     |   | | | |         |   |
+ + +-+-+ +-+ + +-+-+ +-+ +-+ +-+
| | | |   | | |     |     |   | |
+ + + +-+ + + +-+-+ +-+-+-+-+ + +
| | | |   |       |         | | |
+ + + +-+-+ +-+-+ +-+-+-+ + + +-+
| |         |   |     |   | |   |
+ +-+-+ +-+ +-+-+-+-+ +-+ + + + +
|     | | |     |   | | | | | | |
+ +-+ + +-+ +-+ +-+-+ +-+ + + + +
| | | |     | |     |   | |   | |
+ +-+ + +-+ +-+-+-+ +-+-+ +-+ + +
|     | | |                     |
+-+-+-+-+-+-+-+-+-+-+-+-+-+-+-+-+
