+-+-+-+-+-+-+-+-+-+-+-+-+-+-+-+-+
|               |   |           |
+-+-+-+ +-+-+-+ + + + +-+ + +-+ +
| |     | |   | |   |     | | | |
+ + +-+-+ +-+-+ +-+-+ +-+-+ + + +
| | | |       |       | | | | | |
+ + + + +-+-+ + +-+ +-+ + + + + +
|   | | |   | | |   |   | | | | |
+ + + + +-+-+ + + +-+ +-+ + + + +
| | | | | |   | | | | |   | | | |
+ +-+-+ + + +-+ + + + + +-+ + + +
| |   | | | | | | |   | |   | | |
+ + + + +-+ +-+-+ +-+ + + +-+-+ +
| | | | |   | |   | |   | |     |
+ + + + + + + +-+-+ +-+-+ + +-+-+
|   | | | | | |G  |       |     |
+ +-+ + + + + + + +-+-+-+ +-+-+ +
|   |   | | | |   |   |   |     |
+ + + + + + + + +-+ +-+-+ + +-+-+
| | | | |   | |     |   | |     |
+ + +-+ +-+ +-+-+ +-+ + + +-+-+ +
| |       | | | | |   | |   | | |
+ +-+-+-+ + +-+ + + + + +-+ + + +
|   |   | |     | | | |   | | | |
+ +-+ + +-+-+ + + +-+ +-+ + + + +
| |   | |   | | |   |   | | | | |
+ + +-+ +-+-+ + +-+ +-+ + + + + +
| | | |       |         |   | | |
+ + +-+-+-+-+-+ +-+-+ +-+-+ + + +
| |         | | |   |     | | | |
+ +-+-+-+-+ +-+ + + + +-+ +-+-+ +
|             | |   |           |
+-+-+-+-+-+-+-+-+-+-+-+-+-+-+-+-+
