+-+-+-+-+-+-+-+-+-+-+-+-+-+-+-+-+
|             | | | |           |
+-+ + +-+-+-+-+ + + + +-+-+-+ + +
|   |     | |                 | |
+ + +-+ + + + + + + + + +-+-+-+ +
| |   | | |   | | | | | |     | |
+ + + +-+-+ +-+-+-+ +-+-+ +-+ + +
| | |   |         | |     |   | |
+ +-+-+ + +-+-+-+ + + +-+ + + + +
|                 |   | | | | | |
+ +-+-+-+-+ +-+-+-+-+-+ +-+ + + +
|     |     |       |       | | |
+ +-+-+ +-+-+ +-+ + +-+-+-+-+-+ +
|         |       |   |         |
+ +-+ +-+-+ + +-+-+ + + +-+ +-+ +
|   |     | |  G  | | |         |
+ + +-+-+-+ +-+ + + + + + +-+ + +
| |       |   |   | | | |     | |
+ +-+-+-+ +-+ +-+-+ + + +-+ +-+ +
|     |   |     |     |   |   | |
+ +-+-+ +-+-+-+ +-+-+ +-+ +-+ + +
| |   |     |     |     |     | |
+ + + +-+-+ +-+-+ + +-+ +-+ +-+ +
|   |         |             |   |
+ +-+-+ +-+-+ +-+-+ +-+-+ + +-+ +
|   |     |     |         | |   |
+ + + +-+ +-+-+ +-+-+ +-+ + +-+ +
| |   |   | |   | | |   |       |
+ + +-+-+ + + +-+ + +-+ +-+ +-+ +
|   | | | | |   |     |         |
+ + + + + + +-+ + +-+ +-+-+-+-+ +
| |               | |           |
+-+-+-+-+-+-+-+-+-+-+-+-+-+-+-+-+
