+-+-+-+-+-+-+-+-+-+-+-+-+-+-+-+-+
|                               |
+-+ +-+-+-+ +-+-+ +-+-+-+-+-+ + +
|   |   | | |   | | | |     | | |
+ + + + +-+ +-+-+ +-+ + +-+ + + +
| | | |               | |   | | |
+ + + +-+-+-+ +-+-+-+ + + +-+ + +
| | |             | | | |   | | |
+ + + +-+-+-+-+-+ +-+ + +-+ + + +
|   | | |       | |   | |   | | |
+ + + +-+-+ +-+ + + + + + +-+-+ +
| |   |       | | | | | |   | | |
+ + + +-+ +-+-+ + + + + +-+ + + +
| | | |   |   | |   | | |   |   |
+ + + +-+ + + + +-+ + + + +-+ + +
| | | |   | | |G  | |   |   | | |
+ + + + +-+ + + + +-+-+-+-+ + + +
| |   |   | | |   |         | | |
+ +-+-+ +-+ + +-+-+ +-+ +-+-+ + +
|   |     | | |     | | |     | |
+ +-+ +-+ + + +-+ +-+ + +-+-+-+ +
| |     | | | |   | | |   |     |
+ +-+ +-+ + + + +-+-+ +-+ + +-+-+
| |     |   |   |           |   |
+ +-+ +-+ +-+ +-+ +-+-+-+-+-+ +-+
|   |   | |   |               | |
+ +-+ +-+-+ +-+-+-+-+-+-+ +-+ + +
| |   |                 |   | | |
+ +-+ + +-+-+-+-+ +-+-+ +-+ + +-+
| |     |       | | | |         |
+ +-+-+-+ +-+-+ +-+-+ +-+-+-+-+ +
|                               |
+-+-+-+-+-+-+-+-+-+-+-+-+-+-+-+-+
