+-+-+-+-+-+-+-+-+-+-+-+-+-+-+-+-+
|       | |   |   | | | |       |
+-+-+-+ +-+-+ + + + +-+-+ +-+-+ +
|     | |   | | | | | | |     | |
+ +-+-+ + + + + + + + + + +-+-+ +
| |     | | |       |   | | | | |
+ + +-+ + + + +-+-+ +-+-+ + + + +
|     |           |       |   | |
+ +-+-+-+-+-+-+ + +-+-+-+-+-+-+ +
|               | |             |
+ +-+-+-+-+-+-+ + + +-+-+-+-+-+ +
|   |         | | |           | |
+ + + +-+-+-+-+ + +-+-+-+-+-+ + +
| | |           |   |       | | |
+ + + +-+-+-+ +-+-+ +-+-+-+-+ + +
| |           |G  |           | |
+ +-+-+-+-+-+ + + +-+-+-+-+-+-+ +
|             |   |             |
+-+-+ +-+ +-+-+-+ +-+-+ +-+-+-+ +
|       | |           | |       |
+ +-+-+ + + +-+-+-+-+ + + +-+-+ +
| |   | | | |       | | | |   | |
+ +-+-+ +-+ +-+-+-+-+ +-+-+-+-+ +
|       |               |       |
+ +-+ + + +-+-+-+-+-+ + + + +-+ +
| | | | | |           | | | | | |
+ +-+ +-+ +-+-+-+ +-+-+-+-+ +-+ +
|   |   |                   |   |
+-+ +-+-+ +-+-+-+-+-+-+ +-+-+ + +
| |     |               |     | |
+-+-+ +-+-+-+-+-+-+ +-+-+ +-+-+ +
|                               |
+-+-+-+-+-+-+-+-+-+-+-+-+-+-+-+-+
