+-+-+-+-+-+-+-+-+-+-+-+-+-+-+-+-+
|       |   |   |       | |     |
+-+ +-+ + + + + + +-+-+ + + +-+ +
|     |   |   |   |     |     | |
+ +-+ +-+-+-+-+-+ + +-+-+ +-+ + +
|         |       |       |   | |
+-+ +-+ +-+ +-+-+-+-+-+-+-+ +-+ +
|     |     |             |   | |
+ +-+ +-+-+-+ +-+-+-+-+ +-+-+ + +
|       |     |     |     |   | |
+ +-+ +-+-+ +-+ +-+ +-+ +-+ +-+ +
|       |   |     | |     |   | |
+ +-+ +-+ + +-+-+ + +-+ +-+-+ + +
|       | |       | |   |   | | |
+ +-+ +-+ + + +-+-+ + +-+ + + + +
| |   |   | | |G  | |     | | | |
+ + +-+ +-+ +-+ + + +-+-+-+ + + +
|       |     |   |       | | | |
+ +-+-+-+-+ +-+ +-+-+-+-+ + + + +
|           |     |       | | | |
+-+-+-+-+-+-+ + +-+ +-+-+-+ + + +
|   |         |   |         | | |
+ + + +-+-+-+-+ +-+-+-+-+ +-+ + +
| | | |           |     |   | | |
+ + + + + +-+-+-+-+ +-+ +-+ + + +
| | | | |         |   |   |   | |
+ + + + +-+-+-+-+ +-+ +-+ +-+ + +
| | | | |   |   |   |   |   | | |
+ + + + + + + + +-+ +-+ +-+ + + +
| |   |   |   |   |       |   | |
+ +-+-+-+-+-+-+-+ +-+-+-+-+-+ + +
|                               |
+-+-+-+-+-+-+-+-+-+-+-+-+-+-+-+-+
