+-+-+-+-+-+-+-+-+-+-+-+-+-+-+-+-+
|                               |
+-+-+-+ +-+-+ + + + +-+-+ +-+-+ +
|     |       | | |       |     |
+-+-+-+-+-+-+-+ + +-+-+-+-+ +-+-+
|           | | | | |       |   |
+ +-+ +-+-+ + + + + + +-+-+ +-+ +
|   | |   | | | | | | |   | | | |
+ + + + + + +-+ + +-+ + + + + + +
| | | | | |           | | | | | |
+ + + + + +-+-+-+-+-+-+ + + +-+ +
| | |   |   |   |   |   | |   | |
+ + + + + + + + +-+-+ + + + + + +
| |   | | | | |     | | |   |   |
+ + +-+ + + + + +-+ + + + + +-+ +
| | | | | | | |G  | | | | | | | |
+ + +-+ + + + + + + + + + + + + +
|         | | |   | | | | | | | |
+ +-+-+-+ + + +-+-+ + + + + +-+ +
| |   |   | |       |   |       |
+ +-+-+ +-+ +-+ + +-+ +-+ +-+-+ +
|     |       | | |       |     |
+ +-+ +-+ +-+ + + + +-+ +-+ +-+ +
| | |   |   | | | | |   |   | | |
+ +-+-+ +-+ + + + + + +-+ +-+-+ +
| | | |   |   |   |   |   | | | |
+ +-+-+-+ +-+-+ + +-+-+ +-+-+-+ +
|     | |   | | | | |   | |     |
+ +-+ + +-+ + + + + + +-+-+ +-+ +
|   | | | | | | | | | |     | | |
+-+ + + +-+ +-+ + +-+ + +-+ +-+ +
| |                             |
+-+-+-+-+-+-+-+-+-+-+-+-+-+-+-+-+
