+-+-+-+-+-+-+-+-+-+-+-+-+-+-+-+-+
|             |   |             |
+-+-+-+ +-+-+ +-+-+ +-+-+-+-+-+ +
|       |   |       |         | |
+ + +-+ +-+-+ +-+-+ + +-+ +-+ + +
| | | |     |       |   | | | | |
+ + +-+ +-+ +-+-+-+-+ +-+ +-+ + +
| | |   | | | |     | |     | | |
+ + + +-+-+ + + +-+ + +-+ +-+ + +
|   |       | | | | |         | |
+ +-+-+ +-+-+-+ + + +-+-+-+-+-+ +
|               | |             |
+-+ +-+-+ +-+-+-+-+ +-+-+ +-+-+ +
| | |   | |         |   | |     |
+-+ +-+-+ + +-+ +-+ +-+-+-+ + +-+
|     |   | | |G  | |     | | | |
+ +-+ + +-+ + + + + + +-+ + + + +
| | | | | | | |   | | | | | | | |
+ +-+ + +-+ +-+-+-+ + + + + + +-+
|     |   |         | | | |     |
+ +-+-+-+ +-+-+ +-+-+ + + +-+-+ +
|             | |     | |     | |
+ + +-+-+-+-+-+ +-+-+ +-+ +-+ + +
| |         | | |   |   | | | | |
+ +-+-+-+-+ +-+ +-+-+-+ + + + + +
| |         | |           | | | |
+ + +-+-+-+-+-+-+ +-+ +-+ +-+ + +
| | |     |       | | | |       |
+ + + +-+ + +-+-+-+-+ + + +-+-+ +
| |   | |   |       | | | |   | |
+ +-+-+ +-+-+ +-+-+ + +-+ +-+-+ +
|             |   |             |
+-+-+-+-+-+-+-+-+-+-+-+-+-+-+-+-+
