+-+-+-+-+-+-+-+-+-+-+-+-+-+-+-+-+
|     |   |                 | | |
+-+-+ + + + +-+-+-+ +-+ +-+ + +-+
|   | |   | |     | | | | | |   |
+-+-+ +-+-+ +-+-+-+ +-+-+-+ +-+-+
|                     | |       |
+ +-+-+-+ +-+-+ +-+-+-+ +-+-+-+ +
| |     | |   | |             | |
+ + + + + + + + +-+-+-+ +-+-+-+ +
| |     | |   |       | |       |
+ +-+-+-+ +-+-+ +-+-+-+ +-+-+-+ +
|               |             | |
+-+ + +-+-+ +-+-+-+-+-+ +-+-+-+ +
| | | |   | |         | |       |
+ + + +-+-+ + +-+-+-+ + +-+ +-+-+
| | |       | |G  | | | | | |   |
+ + + +-+ +-+ + + + + + + + + + +
| | | | | | | |   | | | | | |   |
+-+ + + + + + + +-+ +-+ + + + + +
|     | | | | |       | | | |   |
+ +-+ + + + + +-+-+-+ +-+ + +-+-+
| | | | | | |       | |   |     |
+ +-+-+ +-+ +-+-+-+-+ +-+-+ +-+ +
|   |               |       | | |
+ +-+-+ +-+ +-+-+-+-+ +-+-+ + + +
| | | | | | |         |   | | | |
+ +-+ + + + + +-+-+-+ +-+-+ + + +
|     | | | | |     |       | | |
+-+-+ + + + + + + + + +-+-+-+ + +
|   | | | | | |     | |       | |
+-+ + +-+ +-+ +-+-+-+ +-+-+-+-+ +
| | |                           |
+-+-+-+-+-+-+-+-+-+-+-+-+-+-+-+-+
