+-+-+-+-+-+-+-+-+-+-+-+-+-+-+-+-+
|           |                   |
+-+-+-+-+-+ + +-+-+ +-+ +-+-+-+ +
|         | | |     | | |       |
+ +-+-+-+ + + +-+-+ + + +-+-+-+ +
|       | | |     | | |       | |
+ +-+-+-+ + + +-+-+ + + +-+-+-+ +
| |           |     | |         |
+ +-+-+-+ + + +-+-+-+ + +-+ +-+ +
|         | |         | | | | | |
+ +-+-+-+ + +-+-+-+-+-+ + + + + +
|       | | |         | | | | | |
+ +-+-+-+ +-+ +-+-+-+ + + + + + +
| |       | |       | | | | | | |
+ +-+-+-+ + + +-+-+ + +-+ + + + +
|         | | |G      |         |
+-+-+-+-+-+ + + + + + + +-+-+-+-+
|           | |   | | | |       |
+ +-+ + +-+ + +-+-+ + + + +-+ + +
| | | | | | |       | | |     | |
+ + + + + + + +-+-+-+ + +-+-+ + +
| | | | | | |         |       | |
+ + + + + + + +-+-+-+-+-+-+-+-+ +
| | | | |   | |       |         |
+ + + + + + + + +-+-+ + +-+-+ +-+
| | | | | |   | |   | | |       |
+ + + + + +-+-+ + + + + + +-+-+ +
| | | | |     | | | | | | |     |
+ + + +-+ +-+ + + +-+ + + + +-+ +
| |           | |     | | | | | |
+ +-+-+-+ +-+-+ +-+-+-+ + + + + +
|                         |     |
+-+-+-+-+-+-+-+-+-+-+-+-+-+-+-+-+
