+-+-+-+-+-+-+-+-+-+-+-+-+-+-+-+-+
|       | | |                   |
+-+-+-+ + + +-+-+ +-+-+ +-+-+-+ +
|     | | |       |           | |
+ + + + + + +-+-+ + +-+-+-+-+ + +
|     | | | |     | |       | | |
+ + + + + + + +-+ + + + + + + + +
|     | | | | | | | |       |   |
+-+-+-+ +-+ + + + +-+-+-+-+ + + +
|           | | |         | | | |
+-+ +-+-+-+-+ + +-+-+-+-+ +-+ + +
| | |         |     |         | |
+ + + +-+-+-+ +-+-+-+ +-+-+-+-+ +
| | | |     | |     |         | |
+ + + + +-+-+ +-+-+ +-+-+-+ +-+ +
|     | |     |G  | |     | | | |
+ +-+-+ + +-+-+ + + +-+-+-+ +-+ +
| | |   | |   |   | |         | |
+ + +-+-+ + + + +-+ +-+ +-+-+-+ +
| |       |   |       | |   |   |
+ + +-+-+-+-+-+-+-+-+ + +-+ + + +
| | |             | | |     | | |
+ + + +-+-+ +-+-+ + + +-+-+ + + +
|   | |   | |   | | |       | | |
+ + + + + + + + + + +-+-+ + + + +
| | | |   | |   | |     | |   | |
+ + + + + + +-+-+ +-+-+ + +-+-+ +
| | | |   |           | |       |
+ + + +-+-+ +-+ +-+-+ + + +-+ +-+
| |         | |       | | | | | |
+ +-+-+-+ +-+-+-+ +-+ +-+ +-+ +-+
|                 | |           |
+-+-+-+-+-+-+-+-+-+-+-+-+-+-+-+-+
