+-+-+-+-+-+-+-+-+-+-+-+-+-+-+-+-+
|                               |
+-+ +-+-+-+-+-+-+-+-+-+-+-+-+-+ +
|   | |                         |
+ +-+ + +-+-+ +-+ +-+-+-+ +-+-+ +
| | |   |                       |
+ + +-+ +-+ +-+-+ +-+-+ +-+-+-+ +
|   | |                         |
+ + + + +-+-+-+-+-+-+-+-+-+-+-+-+
| |   |                         |
+ +-+ +-+-+-+-+-+-+-+-+-+ +-+-+ +
|               |       | |   | |
+ + +-+ +-+-+ + +-+ +-+ +-+ + + +
| | | |   |   |     |       | | |
+ + + +-+ +-+ +-+-+-+-+-+-+-+ + +
| |   | |   | |G  |   |     | | |
+ + + + +-+ + + + + + + +-+ + + +
| | |     |   |   | |   | |   | |
+ + + + +-+ +-+-+ + +-+-+ +-+-+ +
| |   | |   |   | |   |     | | |
+ + + +-+ +-+ + + +-+ + + + + + +
|   | |   |   | | |   | | |   | |
+ + +-+ +-+ +-+ + + +-+ + + + + +
| | |   |   |   | | | | |   | | |
+ +-+ +-+ +-+ + + + +-+ + + + + +
| |   |   |   | | |     | | | | |
+-+ +-+ +-+ +-+ + +-+-+-+ + + + +
|   |   |     | |     | |   | | |
+ +-+ +-+ +-+ + + +-+ + + + + + +
| |   |         |   | |   | |   |
+ + +-+ +-+-+-+-+-+ + + +-+ +-+ +
|   |               |       |   |
+-+-+-+-+-+-+-+-+-+-+-+-+-+-+-+-+
