+-+-+-+-+-+-+-+-+-+-+-+-+-+-+-+-+
|       |                       |
+-+-+-+ + + +-+-+-+-+ +-+-+-+-+ +
|     | | |     |   | |   |   | |
+ +-+ + + +-+-+ +-+-+ +-+-+ + + +
| | | | |     | |         | | | |
+ +-+-+ +-+-+-+ + +-+-+-+-+ + + +
|               |         | | | |
+ +-+-+-+-+-+-+-+-+-+-+-+ + + +-+
| |                     | | |   |
+ + +-+ +-+ +-+-+ +-+-+-+ + + + +
| | | | | | |   | |       | | | |
+ + + + + + + +-+-+ +-+-+-+ + + +
| | | | | | | |   |         | | |
+ +-+-+ +-+ + +-+-+ +-+-+-+ + + +
|         | | |G  | | |   | | | |
+-+-+-+ +-+ + + + +-+ + +-+ + + +
| |   | | | | |     | | | | | | |
+ + + +-+-+ + +-+-+ +-+ +-+-+ + +
| | |       |       |         | |
+ + +-+-+-+-+ +-+ +-+-+ +-+-+-+ +
| | |         | | |   | |       |
+ + +-+-+ + +-+ + +-+-+ + +-+-+ +
| |     | | |   | |     | |   | |
+ +-+-+ + + +-+-+ +-+-+ + +-+-+ +
| |   | | |     |       |       |
+ +-+-+ +-+-+-+ + +-+-+ + +-+-+ +
|             | |     | |       |
+ +-+-+-+-+-+ + +-+-+ + + +-+-+ +
| |     |     |     |   | |   | |
+ +-+-+-+ +-+-+-+-+ +-+-+ +-+-+ +
|                               |
+-+-+-+-+-+-+-+-+-+-+-+-+-+-+-+-+
