+-+-+-+-+-+-+-+-+-+-+-+-+-+-+-+-+
|     | |       | | | |         |
+-+-+ + +-+ +-+ + + + + + +-+-+ +
| |   |   |   |   |   | | |   | |
+ +-+ + + +-+ +-+ + + + + + + + +
|       |   |   |   | | | | | | |
+-+-+-+ +-+ +-+ +-+ + + + + + + +
|         |   |   | | | | | | | |
+-+ +-+ + +-+ +-+ + + + + + + + +
| |   | |   |   | | | | |   | | |
+ +-+ +-+ +-+-+ + + + + + + + + +
|   |   |     |   | | | | | | | |
+ + +-+ +-+-+ +-+-+-+ + + + + + +
| |   |   |         |   | | | | |
+ +-+ +-+ +-+ +-+-+ +-+-+ + + + +
|   |   |   | |G  | |     | | | |
+-+ +-+ +-+ + + + +-+-+-+-+-+ + +
|     |     | |             | | |
+-+-+ +-+-+-+ +-+-+ +-+-+ +-+ + +
|           |   |   |         | |
+-+ +-+-+-+-+-+-+ + + + +-+-+-+ +
|             | | |   |         |
+-+-+-+-+-+-+ + + + + +-+-+-+-+ +
|             | | | | |     |   |
+ +-+-+-+-+-+-+ + + + + + + +-+ +
|               | | | |   | |   |
+ +-+-+-+-+-+-+ + + + +-+ + +-+ +
| |             | | |   |   |   |
+ + +-+-+-+-+ +-+-+ + +-+ +-+-+ +
| |                 | |   |     |
+ +-+-+-+-+-+-+-+-+-+ +-+-+ + +-+
|                           |   |
+-+-+-+-+-+-+-+-+-+-+-+-+-+-+-+-+
