+-+-+-+-+-+-+-+-+-+-+-+-+-+-+-+-+
|     |   |         |       |   |
+-+-+ +-+-+ +-+-+-+ +-+-+-+-+ + +
|   |       |     |           | |
+ + +-+-+-+-+ +-+ +-+-+-+-+-+-+ +
| |           | |               |
+ +-+-+-+-+-+-+ +-+-+-+-+-+-+-+-+
|   | |                         |
+-+ +-+ +-+-+ +-+-+ +-+-+-+-+-+ +
|   |                 |         |
+ +-+-+-+ +-+-+ +-+-+ + +-+-+-+-+
|   |                 |         |
+-+ + + + +-+-+-+-+-+ +-+-+-+-+ +
| | | | | | |       | |         |
+ + + + + + + +-+-+ + + +-+-+-+-+
| | |   | | |  G  |   |         |
+-+ +-+ + + +-+ + + + +-+-+-+-+ +
|     | | | | |   | | |         |
+-+ +-+ + + +-+-+-+ + + +-+-+-+-+
| | |   | |       | | |         |
+ + + + +-+ + +-+ + + +-+-+-+-+ +
| | | |     |                   |
+-+ + +-+-+-+-+-+-+ +-+-+-+-+-+-+
|   | |           | |           |
+ +-+ + +-+-+-+-+ + + +-+-+-+-+ +
| |   | |       | | | |         |
+ + + + + +-+-+ + + + + +-+-+-+-+
| | | | | |   | | | | | |       |
+ +-+ + + + + + + + + + + +-+-+ +
| |   | | | | | | | | | | |     |
+ + +-+ + + + + + + + + + + +-+-+
|   | |   | |   |     |   |     |
+-+-+-+-+-+-+-+-+-+-+-+-+-+-+-+-+
