+-+-+-+-+-+-+-+-+-+-+-+-+-+-+-+-+
|                               |
+-+-+-+-+-+-+-+-+ +-+-+-+-+-+-+-+
|   |           | |         |   |
+ + +-+-+ +-+-+-+ +-+-+ +-+-+ + +
| |                           | |
+ + +-+-+-+-+-+-+ +-+-+-+-+-+ + +
| |                           | |
+ + +-+-+-+ +-+-+-+-+ +-+-+-+ + +
| |                           | |
+ + +-+-+-+ +-+-+-+-+ +-+-+-+ + +
| |                           | |
+ +-+-+-+-+ +-+-+-+-+ +-+-+-+-+ +
| |                           | |
+ +-+-+-+-+-+-+-+-+-+-+-+-+-+-+ +
|             |G  |             |
+-+ + + + + + + + + + + + + + +-+
| | | | | | | |   | | | | | | | |
+ + + + + + + +-+ + + + + + + + +
|     | | | | | | | | | | |     |
+ +-+-+ + + + + + + + + + +-+-+ +
|     | | | | | | | | | | |     |
+ +-+-+ + + + + + + + + + +-+-+ +
|             | | |             |
+-+-+ + + + + + + + + + + + +-+-+
|   | | | | | | | | | | | | |   |
+ +-+ + + + + + + + + + + + +-+ +
|     | | | | | | | | | | |     |
+ +-+-+ + + + + + + + + + +-+-+ +
|     |       |   |       |     |
+ +-+-+-+-+-+-+ +-+-+-+-+-+-+-+ +
|                               |
+-+-+-+-+-+-+-+-+-+-+-+-+-+-+-+-+
