+-+-+-+-+-+-+-+-+-+-+-+-+-+-+-+-+
|     |                   |     |
+-+-+ + + + +-+-+-+-+ + + + +-+-+
|       | | |       | | |       |
+-+-+ +-+ + + +-+ + + + +-+ +-+-+
|         | |   | | | |         |
+-+ +-+-+-+ + + + + + +-+-+-+ +-+
|           | | | | |           |
+ +-+-+-+-+-+ + + + +-+-+-+-+-+ +
| |           | | |           | |
+ + +-+-+-+-+-+ + +-+-+-+-+-+ + +
| | |           |         | | | |
+ + + +-+-+-+-+-+-+ +-+ + + + + +
| | | |   |     |     | | | | | |
+ + + + + + + +-+-+ + + + + + + +
| | | | | | | |G  | |   | | | | |
+ + + + + + + + + +-+ + + + + + +
| | | | | | | |     | |     | | |
+ + + + + + + +-+-+ +-+ + +-+ + +
| | | | | | |       |   |   | | |
+ + + + + + +-+ + +-+-+-+-+ + + +
| | | | | | |   | |   |   | | | |
+ + + + + + + + + + + + + + + + +
| | | | | |   | | | | | | | | | |
+ + + + + +-+ + + + + + + + + + +
| | | | | |     | | | | | | | | |
+ + + + + + + + + + + + + + + + +
| | | | | | | | |   |   | | | | |
+ + + + + + + + +-+-+-+-+ + + + +
| | |   |       |           | | |
+ + +-+-+ +-+-+ +-+-+-+-+-+-+ + +
|   |           |               |
+-+-+-+-+-+-+-+-+-+-+-+-+-+-+-+-+
