+-+-+-+-+-+-+-+-+-+-+-+-+-+-+-+-+
|       |                 | |   |
+-+-+-+ + +-+-+-+-+-+-+-+ + + + +
|     | |                 | |   |
+ + + + + +-+-+-+ +-+-+-+ + + + +
|     | | |               | |   |
+-+-+-+ + +-+-+-+-+-+-+-+ +-+ + +
|       |   |   |   |   |   |   |
+ +-+-+-+ + + + + + + + + + + + +
| | |     | | | | | | | | | |   |
+ + + + +-+ + + + + + + + + +-+ +
| | | | | |   |   |   | | |   | |
+ +-+ + + + +-+-+-+-+ + + + + + +
|   | | | | |       | | | | | | |
+ +-+ + +-+ + +-+-+ +-+ + + + +-+
| |   |     |  G  |       | |   |
+ + +-+-+-+ + + + + +-+-+-+-+-+ +
| |   |   | | |   |         |   |
+ + + + +-+ + +-+-+ +-+ + + + +-+
|   | | | | |       | | | | | | |
+ + + + + + +-+-+-+-+ + + + + + +
| | |   | |   |   |   | | |   | |
+ + + + +-+ + + + + + + + + +-+ +
| |   |   | | | | | | | | | |   |
+ +-+-+-+ + + + + + + + + + + + +
|       |   |   |   |   |   |   |
+-+-+-+ + +-+-+-+-+-+-+-+ + + + +
|     | | |               | |   |
+ + + + + +-+-+-+ +-+-+-+ + + + +
|     | |           |     | |   |
+-+-+-+ + +-+-+-+-+-+-+-+-+ + + +
|                           |   |
+-+-+-+-+-+-+-+-+-+-+-+-+-+-+-+-+
