+-+-+-+-+-+-+-+-+-+-+-+-+-+-+-+-+
|           | |                 |
+-+-+-+ +-+ +-+ +-+-+-+ +-+-+-+ +
|       | |     |             | |
+ +-+-+-+-+ +-+-+ +-+-+-+-+-+ + +
| |         |         |     | | |
+ + +-+-+-+-+ +-+-+-+ +-+-+ + + +
| | |           | |   |   | | | |
+ + +-+ +-+-+ + +-+ +-+-+ + + + +
| | | | | |   |     | | | | | | |
+ + + + + +-+-+-+-+ + +-+-+-+ + +
| | | | | | |     | |   |   | | |
+ + +-+ + + +-+-+-+ +-+-+ + +-+ +
|   |   | | |             | |   |
+-+ + +-+ + +-+-+-+-+-+-+-+ + +-+
| |   |   | |  G  |         | | |
+ + + + + + + + + + +-+-+-+-+ + +
| | | |   | | |   |         | | |
+-+ + +-+ + + +-+-+-+-+-+-+ + +-+
|   |   | | |             | |   |
+ + +-+ + + +-+-+-+ +-+-+ + +-+ +
| | | | | | |     | |   |     | |
+ + + + + +-+-+-+-+ + +-+-+-+ + +
| | | | | |         | | | | | | |
+ +-+-+ +-+-+ + +-+ +-+-+ + + + +
| |         | | | |   |   | | | |
+ + +-+-+-+-+ +-+-+-+ +-+-+ + + +
| |         |         |     | | |
+ +-+-+-+-+ +-+-+ +-+-+-+-+-+ + +
|       | |     |             | |
+-+-+-+ +-+ +-+ +-+-+-+ +-+-+-+ +
|     |     | |                 |
+-+-+-+-+-+-+-+-+-+-+-+-+-+-+-+-+
