+-+-+-+-+-+-+-+-+-+-+-+-+-+-+-+-+
|                   |           |
+-+-+-+ +-+ +-+ +-+-+-+-+ +-+-+ +
|     | | | | | |       |     | |
+-+-+-+ +-+-+-+ +-+-+-+-+-+-+ + +
|         | |                 | |
+ +-+-+-+-+ +-+-+-+-+ +-+-+-+-+ +
| |                 | | | |   | |
+ +-+-+ +-+ +-+-+-+-+ +-+-+ + + +
|         | |             | | | |
+ +-+-+-+-+ +-+-+-+-+-+-+ + + + +
| |                 | | | | |   |
+ +-+-+-+-+ +-+-+-+-+-+ + + + + +
|         | |       |   |   | | |
+ +-+ +-+ + + +-+-+ + + + + + + +
| |     | | |  G  | | | | | | | |
+ + +-+ + + + + + + + + + + + + +
| | | | |   | |   |   | | |   | |
+ + +-+ + + + +-+-+-+-+ +-+-+-+ +
| |     | | |       | |         |
+ +-+ +-+ + + +-+-+-+ +-+-+-+-+ +
|         | |         |       | |
+-+-+-+-+ +-+-+-+-+-+ +-+-+-+-+ +
|         |         | |         |
+ +-+-+-+-+ +-+-+-+-+ +-+-+-+-+ +
| |       | |         |       | |
+ +-+-+-+-+ +-+-+-+-+ +-+-+-+-+ +
|               |   | |         |
+ +-+-+-+ +-+-+-+ +-+ +-+ +-+-+ +
| | |     |     | | | | | |   | |
+ +-+ +-+-+-+-+-+ +-+ +-+ +-+-+ +
|                               |
+-+-+-+-+-+-+-+-+-+-+-+-+-+-+-+-+
