+-+-+-+-+-+-+-+-+-+-+-+-+-+-+-+-+
|         |                     |
+-+-+-+ +-+-+ +-+-+-+ +-+-+-+-+ +
|     | |   | |     | |         |
+-+-+-+ +-+ + +-+-+-+ + +-+ +-+ +
|         | |         | |     | |
+ +-+-+-+-+ +-+ +-+-+-+ +-+-+ + +
| |               |         |   |
+ + +-+ +-+-+-+-+ +-+-+-+-+ + +-+
| | |           |           | | |
+ + +-+-+-+ +-+-+ +-+-+ +-+-+ +-+
| |       | |       | | |     | |
+ + + + +-+ + +-+-+ + + +-+ + +-+
| | | | |   | |     | |   | | | |
+ +-+ + +-+-+ +-+-+-+ +-+-+ + +-+
|     |   |   |G  | |       | | |
+ +-+-+-+-+-+-+ + + +-+-+-+-+ +-+
|     |   |   |   | |         | |
+ +-+ + +-+ + + +-+-+ +-+-+ + +-+
| | | | |   |         |   | | | |
+ + + + +-+ + +-+-+-+ + +-+ + +-+
| | |     | |         | |     | |
+ + +-+-+-+ +-+-+-+-+-+ +-+-+ +-+
| |         |               | | |
+ + +-+ +-+-+ +-+-+-+ +-+-+ + +-+
| |                         |   |
+ +-+-+-+-+ +-+-+ +-+-+ +-+-+ + +
|         | |         | |     | |
+ +-+-+ +-+ + +-+-+-+ + +-+ +-+ +
| |   | |   | |     | |   | | | |
+ +-+-+ +-+-+ +-+-+-+ +-+-+-+-+ +
|             |                 |
+-+-+-+-+-+-+-+-+-+-+-+-+-+-+-+-+
