+-+-+-+-+-+-+-+-+-+-+-+-+-+-+-+-+
|             |   |             |
+-+-+-+ + +-+ +-+-+ +-+ +-+ +-+ +
|     | | | |       | | | | | | |
+-+-+-+ + + +-+-+-+-+ + +-+ + + +
|   | | | |   | | |   |     | | |
+ + +-+ + +-+-+ + +-+-+ +-+-+ + +
| |                     | |   | |
+ +-+ +-+-+-+-+-+-+-+-+-+-+-+-+ +
|               |       |       |
+ +-+-+ + +-+-+-+-+-+-+ + +-+-+ +
| |   | | |   |   |   | | |   | |
+ +-+ + + + +-+-+-+-+ + + + + + +
|   | | | | |       | | | | |   |
+ + + + + + + +-+-+ +-+ +-+ + +-+
| | | |   | | |G  |     | | | | |
+ + + +-+ + + + + + +-+ + + +-+ +
| | | |   | | |   | | | | | | | |
+ + + + + + + + +-+ +-+ +-+ + +-+
|   | | | | |       | |   | |   |
+ +-+ + + + +-+-+-+-+ + + + + + +
| |   | | |   |   |   | | |   | |
+ +-+-+ + +-+-+-+-+-+-+ + +-+-+ +
|       |       |       |       |
+-+-+ +-+-+-+-+-+-+-+-+-+ +-+-+ +
| | | | |               | |   | |
+ +-+ +-+ +-+-+ + +-+-+ + +-+ + +
|     | | |     |     | |   | | |
+ +-+-+ + + +-+-+-+-+ + + + + + +
| |     | | |       | | | | | | |
+ +-+-+-+ + + +-+-+ + + + + +-+ +
|                               |
+-+-+-+-+-+-+-+-+-+-+-+-+-+-+-+-+
