+-+-+-+-+-+-+-+-+-+-+-+-+-+-+-+-+
|     |                 |   |   |
+-+-+ + +-+-+-+ +-+-+-+ + + + + +
| | |   |     |     |   | |   | |
+ +-+ + + + + + +-+ + +-+ +-+-+ +
|     | | | |   |   |   |       |
+ + +-+ + + + +-+ + + + +-+-+-+ +
| | |   | | |     | | |         |
+ + + + + + +-+-+ + + +-+-+ +-+ +
| |   | | |       |   | | |   | |
+ + + + + +-+ +-+-+-+-+ +-+ + + +
|   |   |   | |       |   | |   |
+ + +-+-+-+ + + +-+-+ +-+-+ + + +
| | |   | |   |       |     | | |
+ + + + +-+-+-+-+-+ +-+ +-+ + + +
| |   |       |G  | |   |   | | |
+ + +-+-+-+-+ + + + + +-+ +-+ + +
| | |   |     |   | |     |   | |
+ + + + + +-+-+-+ + + +-+-+ + + +
| | | | | |       | |       |   |
+ + + + + + +-+ +-+ +-+-+-+-+-+ +
|   | |   | |     |             |
+ +-+ + +-+ + +-+ +-+-+-+ +-+-+-+
| |   | | |       |     |     | |
+ + + + +-+ +-+-+ + +-+ +-+-+ + +
| | | | | |         | |     |   |
+ + + + + +-+ +-+-+-+-+ +-+ +-+ +
| |   | |   |         |   | | | |
+ +-+ + + + +-+-+-+-+ +-+ + +-+ +
| | | | | | |       |   |       |
+ +-+ + + + + +-+-+ +-+ +-+-+ +-+
|     |   |                   | |
+-+-+-+-+-+-+-+-+-+-+-+-+-+-+-+-+
