+-+-+-+-+-+-+-+-+-+-+-+-+-+-+-+-+
|           | |                 |
+-+-+-+ +-+ +-+ +-+-+-+ +-+-+-+ +
|       | |     |             | |
+ +-+-+-+-+ +-+-+ +-+-+-+-+-+ + +
| |         |         |     | | |
+ + +-+-+-+-+ +-+-+-+ +-+-+ + + +
| | |   |     | | |   |   | | | |
+ + + + +-+-+ + +-+ +-+-+ + + + +
| | | | | |   |     | | | | | | |
+ + + + + +-+ +-+-+ + +-+-+-+ + +
|   | | | | |     | |   |     | |
+ + + + + + +-+-+-+ +-+-+-+-+-+ +
| |   | | | |     |         |   |
+ + +-+ + + + +-+-+-+-+-+-+ + + +
| | |   | | |  G  |         | | |
+ + +-+ + + + + + + +-+-+-+-+ + +
| | | | | | | |   |         | | |
+ + +-+ + + + +-+-+-+-+-+-+ + + +
| | |   | | |             | |   |
+ + + + + + +-+-+-+ +-+-+ + +-+ +
| | | | | | |     | |   |     | |
+ + + + + +-+ +-+-+ + +-+-+-+ + +
|   | | | |   |     | | | | | | |
+ +-+ +-+-+-+ + +-+ +-+-+ + + + +
| |           | | |   |   | | | |
+ + +-+-+-+-+ +-+-+-+ +-+-+ + + +
| |         |     |   |     | | |
+ +-+-+-+-+ +-+-+ + +-+-+-+-+ + +
|       | |     |             | |
+-+-+-+ +-+ +-+ +-+-+-+-+ +-+-+ +
|     |     | |                 |
+-+-+-+-+-+-+-+-+-+-+-+-+-+-+-+-+
