+-+-+-+-+-+-+-+-+-+-+-+-+-+-+-+-+
|               |               |
+-+-+-+ +-+-+ + + + +-+-+ +-+-+ +
| |   | |   | |   | |   | |     |
+ +-+-+ +-+-+-+-+-+-+-+-+ +-+ +-+
|             |   |             |
+ +-+-+-+ +-+ + + + +-+ +-+-+-+ +
| |     | | | | | | | | |     | |
+ + +-+ + +-+ + + + +-+ + +-+ + +
| | | | | |     |     | | | | | |
+ + + + + +-+-+ + +-+-+ + + + + +
| | | |       | | |       | | | |
+ + + + +-+-+-+ + +-+-+-+ + + + +
| |   | |   | |   | |   | |   | |
+ +-+ + +-+-+-+-+-+-+-+-+ + +-+ +
|           |  G  | |           |
+-+ +-+-+-+ + + + + +-+-+-+-+ +-+
| | |   |   | |   | |   |   | | |
+-+ +-+-+ +-+ +-+-+ +-+ +-+-+ +-+
| |       |         | |       | |
+ + +-+-+-+ +-+-+-+ + +-+-+-+ + +
|   |   |   |   | | |   |   |   |
+ + + +-+ +-+ + + + +-+ +-+ + + +
| | | | | | | | | |   | | | | | |
+ + + +-+ + + + + + + + +-+ + + +
| | |     | | | | | | |     | | |
+ + +-+-+-+ + + + + + +-+-+ + + +
|   |       | |   | |       |   |
+ + + +-+-+ + + + + + +-+-+ + + +
| | |   |   | | |   | | |   | | |
+ + + + + + + + + + + + + +-+ + +
|     |   |   |   |   | |     | |
+-+-+-+-+-+-+-+-+-+-+-+-+-+-+-+-+
