+-+-+-+-+-+-+-+-+-+-+-+-+-+-+-+-+
|         |                     |
+-+-+-+-+ + +-+ +-+-+-+ +-+-+ + +
|       | |   | |     | |   | | |
+-+-+-+-+ +-+ + +-+-+-+ + +-+ + +
|           | |         |       |
+ +-+-+-+-+-+ +-+-+-+-+-+ +-+-+ +
| |               |           | |
+ + +-+ +-+-+-+-+ +-+-+ +-+-+ + +
| | |           |             | |
+ + +-+-+-+-+ +-+-+ +-+-+ +-+-+ +
| |         | |         | |     |
+ + + +-+ +-+ + +-+-+-+ + +-+ + +
| | | | | |   |     | | |   | | |
+ +-+ + + +-+-+-+-+ +-+ +-+-+ + +
|     | |     |G  |       |   | |
+ +-+-+ +-+-+ + + +-+-+-+-+-+-+ +
|     | |     |   |             |
+ +-+ + + +-+-+ +-+ +-+ +-+-+ + +
| | | | | |   |     | | |   | | |
+ + + +-+ +-+ + +-+-+-+ + +-+ + +
| | |       | |         |       |
+ + +-+-+-+-+ +-+-+-+-+-+ +-+-+ +
| |                           | |
+ + +-+-+ +-+-+-+-+-+-+-+-+-+ + +
| |                           | |
+ +-+-+-+-+-+ +-+-+ +-+-+ +-+-+ +
|           | |         | |     |
+ +-+-+-+ +-+ + +-+-+-+ + +-+ +-+
| |     | |   | |     | |   | | |
+ +-+-+-+ +-+-+ +-+-+-+ +-+-+ +-+
|                     |         |
+-+-+-+-+-+-+-+-+-+-+-+-+-+-+-+-+
