+-+-+-+-+-+-+-+-+-+-+-+-+-+-+-+-+
|                       |       |
+-+ +-+ +-+-+-+ + +-+ +-+-+ +-+ +
|     |     |   |       |   |   |
+ +-+ +-+ +-+ + + +-+-+-+ +-+-+ +
| |     |     |   |   |     |   |
+ + +-+ +-+ +-+ +-+ +-+ + +-+-+ +
|   |         |   | |   |     | |
+ + + +-+-+ +-+ +-+ + +-+ + + + +
| |           | |     | | | | | |
+ + +-+ +-+-+ +-+ +-+-+ +-+ +-+ +
| |     |                 | |   |
+ +-+-+-+ +-+-+-+-+-+-+-+-+-+-+ +
|         | |         |         |
+ +-+ +-+-+-+ +-+-+ +-+-+-+ +-+ +
|   |       | |G  |     |     | |
+ + +-+-+-+-+ + + + + +-+ +-+-+ +
| |         | |   | |   |     | |
+ +-+ +-+-+-+ + +-+ +-+ +-+-+ + +
|   |     | |   |     |   |   | |
+ + +-+-+ +-+-+ +-+ + +-+ + +-+ +
| |     |     | | | |   |     | |
+ + +-+ +-+ +-+ + + +-+ +-+ +-+ +
|     |   |   |   |   |   | |   |
+ +-+-+-+-+ +-+-+ +-+ +-+ + +-+ +
|     |   |     |   | | | |     |
+ + + +-+ +-+-+-+-+ + + + +-+-+ +
| | |     |     | |   | |     | |
+ + +-+-+ + +-+ + +-+-+ +-+-+ + +
|     | | |     | | | | | | |   |
+ + +-+ +-+ +-+ + + + + + + +-+ +
| |         | |                 |
+-+-+-+-+-+-+-+-+-+-+-+-+-+-+-+-+
