+-+-+-+-+-+-+-+-+-+-+-+-+-+-+-+-+
|             |   |             |
+-+-+-+ + +-+ +-+-+ +-+ +-+-+-+ +
|     | | | |       | | | | | | |
+-+-+ + + + +-+-+-+-+ + +-+ + + +
|   | | | |     | |   | |   | | |
+ + +-+ + +-+-+-+ +-+-+ + +-+ + +
| |                     | |   | |
+ +-+ +-+-+-+ +-+-+-+-+-+ +-+-+ +
|           |         | |       |
+ +-+-+ + +-+-+-+-+-+-+-+ +-+-+ +
| |   | | |   |   |   | | |   | |
+ +-+ + + + +-+-+-+-+ + + + + + +
|   | | | | |       | | | | |   |
+ + + + + + + +-+-+ +-+ +-+ + +-+
| | | | | | | |G  |     | | | | |
+ + +-+ + +-+ + + + +-+ + + +-+-+
| | | |   | | |   | | | | | | | |
+ + + + + + + + +-+ + + +-+ + +-+
|   | | | | |       | |   | |   |
+ +-+ + + + +-+-+-+-+ + + + + + +
| |   | | |   |   |   | | |   | |
+ +-+-+ +-+-+-+-+-+-+-+ + +-+-+ +
|       | |         |   |       |
+-+ + +-+-+ +-+-+-+ +-+-+ +-+-+ +
| | | | |           |     |   | |
+-+ + +-+ +-+-+-+-+-+-+ + +-+ + +
|     | | |           | |   | | |
+ +-+-+ + + +-+-+-+-+ + +-+ + + +
| |     | | |       | | | | | | |
+ +-+-+-+ + + +-+-+ + + +-+ +-+ +
|                               |
+-+-+-+-+-+-+-+-+-+-+-+-+-+-+-+-+
