+-+-+-+-+-+-+-+-+-+-+-+-+-+-+-+-+
|                       | |     |
+-+-+-+ + +-+-+ + +-+-+ +-+ +-+ +
|     | | |     |     |     | | |
+ +-+ + + +-+-+ +-+ +-+ +-+ + + +
|   |   | |     | | |   | | | | |
+ + + + + +-+-+ +-+ +-+-+-+ +-+ +
| | | | |           |           |
+ + +-+-+ +-+-+-+-+-+ +-+ +-+-+ +
| |       |   |     | | |   | | |
+ +-+-+ +-+-+-+ +-+ +-+ +-+ + + +
|       |       | |         | | |
+ +-+-+-+ +-+-+ +-+-+ +-+-+-+-+ +
|       | |   |   | |           |
+ +-+ + + +-+-+-+-+-+-+-+-+-+ +-+
|   | |       |G    |   | | | | |
+-+ + + +-+-+ + + + +-+ + +-+ +-+
| | | | |   | |   |   |   |     |
+ + + +-+-+-+ +-+-+ + +-+ +-+-+ +
| | |         | | | |   |       |
+-+ +-+-+-+ +-+ +-+ +-+-+ +-+-+ +
|             |         |   | | |
+-+-+ +-+-+-+-+-+ +-+ +-+-+-+-+ +
|     |       | | | | |     |   |
+ +-+-+ +-+-+ +-+ +-+ + +-+ + + +
| |   | |   |   |   | |   |   | |
+ +-+-+ +-+ + +-+-+ +-+-+ +-+-+ +
| |   |   |   |     |   |   |   |
+ + +-+ + +-+ +-+-+ + + + +-+-+ +
| | |   |   |     | | | | |   | |
+ + +-+ +-+-+ +-+-+ + + + + + + +
|       |             |     |   |
+-+-+-+-+-+-+-+-+-+-+-+-+-+-+-+-+
