+-+-+-+-+-+-+-+-+-+-+-+-+-+-+-+-+
|       | |   |         |       |
+-+-+-+ + +-+ + +-+ +-+-+ +-+-+ +
|     | | |   | | |           | |
+ +-+ + + + + + +-+-+-+-+-+ +-+ +
| | | | | | | |     |   |     | |
+ + + + +-+ + + +-+ +-+-+ +-+-+ +
| | |       |   | |     |       |
+ + + +-+-+ +-+ + +-+-+ + +-+-+ +
| | | |   | | | |     | |   | | |
+ +-+ +-+-+-+-+ +-+-+-+ +-+ + + +
|         | |           |   | | |
+ +-+-+-+ +-+ +-+-+-+-+-+ +-+-+ +
|   | | | | |                   |
+ + + +-+ + + +-+-+-+-+-+-+-+-+ +
| | | |   | | |G  |     |       |
+ + + +-+ + +-+ + + +-+ + +-+-+ +
| | | | | |   |   | | | |   | | |
+ + +-+ + +-+-+ +-+ + + + +-+ + +
| | | | | | |       | | | | | | |
+ + + + +-+ + +-+-+-+-+ + + +-+ +
|   |       |         |         |
+ + +-+-+ +-+-+-+-+-+ + +-+-+-+ +
| |       | | | | | | | | |     |
+ + +-+-+ +-+ + + +-+ + + + +-+-+
| | |         | | |   | | |     |
+ +-+ +-+-+-+-+ + +-+ + + + +-+ +
| |           | |   | | | | | | |
+ + +-+ + +-+ + +-+ + +-+-+ + + +
| |     | | | |   | |       | | |
+ +-+-+-+ + + +-+-+ +-+-+ +-+-+ +
|         | |                   |
+-+-+-+-+-+-+-+-+-+-+-+-+-+-+-+-+
