+-+-+-+-+-+-+-+-+-+-+-+-+-+-+-+-+
|     |                       | |
+-+-+ + +-+-+-+ +-+-+-+-+ +-+ + +
|   | |                   | | | |
+-+-+ + + + +-+-+ +-+-+-+ +-+ + +
|     | | | |   |     | |   | | |
+ +-+-+ + + + + +-+-+ +-+ + + + +
| | |   |   | | |   |     | | | |
+ + + + + + + + + + +-+-+ + + + +
| | | | | | | | | | |   | | | | |
+ +-+ + + + + + + + + + +-+ + + +
|   | | | |   |   |   | | |   | |
+ +-+ + + + +-+-+-+-+-+ + + + + +
| | | | | | |       | | | | | | |
+ +-+ + +-+ + +-+-+ +-+ + + + +-+
| |   |   | |  G  |             |
+ + +-+-+ + + + + + +-+-+-+-+-+ +
| |   |   | | |   |             |
+ + + + +-+ + +-+-+ +-+ + + + +-+
|   | | | | |       | | | | | | |
+ +-+ + + + +-+-+-+-+-+ + + + + +
|   | | | |   |   |   | | |   | |
+ +-+ + + + + + + + + + +-+ + + +
| | | | | | | | | | |   |   | | |
+ + + + + + + + + + +-+-+ +-+ + +
| | |   |   | | |   |     | | | |
+ +-+-+ + + + + +-+-+ +-+ + + + +
|     | | | |   |     | | | | | |
+-+-+ + + + +-+-+ +-+-+-+ + + + +
|   | |                   | | | |
+-+-+ +-+-+-+-+ +-+-+-+-+-+ + + +
|                             | |
+-+-+-+-+-+-+-+-+-+-+-+-+-+-+-+-+
