+-+-+-+-+-+-+-+-+-+-+-+-+-+-+-+-+
|     | |             |         |
+-+-+ + + +-+-+-+-+-+ +-+-+-+ + +
|     | |                   |   |
+ +-+-+-+ +-+-+ +-+-+-+-+-+ +-+-+
| | |     |   |           |     |
+ + + +-+-+-+-+-+-+-+-+-+ +-+-+ +
| | | |                 |     | |
+ +-+ + +-+-+-+-+-+-+-+ +-+-+ + +
|   | | |     |       |     | | |
+ +-+ + + +-+-+ +-+-+ +-+-+ + + +
| |   | | |   | |   |     | | | |
+ +-+ + + + +-+ +-+-+-+-+ +-+ + +
| | | | | | |       |   |     | |
+ + + +-+ +-+ +-+-+ +-+-+-+-+-+ +
| | |       | |G  |             |
+ +-+ +-+-+-+ + + + +-+-+ +-+-+-+
|           |     |             |
+ +-+-+-+ +-+ +-+-+ +-+-+-+-+ + +
| | | | | | |       |   |     | |
+ + + + + + +-+-+-+-+-+-+ +-+ + +
| | | | | |   | |   |     | | | |
+ +-+ + + +-+-+ +-+-+ +-+-+ + + +
|   | | |     |       |     | | |
+ +-+ + +-+-+-+-+-+-+-+ +-+-+ + +
| | | |                 |     | |
+ + + +-+-+-+-+-+-+-+-+-+ +-+-+ +
| | |                     |     |
+ +-+-+-+ +-+-+ +-+-+-+-+ + +-+-+
|     | | |   | |   |     | |   |
+-+-+ +-+ +-+-+ +-+-+ +-+-+ +-+-+
|                               |
+-+-+-+-+-+-+-+-+-+-+-+-+-+-+-+-+
