+-+-+-+-+-+-+-+-+-+-+-+-+-+-+-+-+
|       |                       |
+-+-+-+ + +-+ +-+-+-+-+ +-+-+ + +
|     | |   | |       | |   | | |
+-+-+-+ +-+ + +-+-+-+-+ + +-+ + +
|         | |           |       |
+ +-+-+-+-+ +-+-+-+-+-+-+ +-+-+ +
| |             |             | |
+ + +-+ +-+-+-+ +-+-+ +-+-+-+ + +
| | |         |               | |
+ + +-+-+-+-+ +-+-+ +-+-+ +-+-+ +
| |         | |         | |     |
+ + +-+ + +-+ + +-+-+-+ + +-+ + +
| |   | | |   |     | | |   | | |
+ +-+-+ + +-+-+-+-+ +-+ +-+-+ + +
|       |     |G  |       |   | |
+ +-+-+-+-+-+ + + +-+-+-+-+-+-+ +
| |           |   |             |
+ + +-+-+ +-+ + +-+ +-+-+ +-+-+ +
| | |   | | | |     |   | |   | |
+ + +-+ + +-+-+-+-+ + + + + + + +
|     | |     |     | |     | | |
+ +-+-+ +-+-+-+-+-+-+ +-+-+-+ + +
| |                           | |
+ + +-+-+ +-+-+-+-+-+-+-+ +-+ + +
| |                 |         | |
+ +-+-+ +-+-+ +-+-+-+ +-+-+-+-+ +
|     | |           | |         |
+-+ +-+ + +-+-+-+-+ + +-+ +-+-+-+
| | |   | |       |     | |     |
+-+ +-+-+ +-+-+-+-+ +-+-+ +-+-+-+
|                 |             |
+-+-+-+-+-+-+-+-+-+-+-+-+-+-+-+-+
