+-+-+-+-+-+-+-+-+-+-+-+-+-+-+-+-+
|     |             |           |
+-+-+ +-+ +-+-+-+-+ +-+-+-+-+-+-+
|     | |                   |   |
+ +-+-+-+ +-+-+ +-+-+-+-+-+ +-+-+
| | |     |   |           |     |
+ + + +-+-+-+-+-+-+-+-+-+ +-+-+ +
| | | |                 |     | |
+ +-+ + +-+-+-+-+-+-+-+ +-+-+ + +
|   | | |       |     |     | | |
+ +-+ + + +-+-+-+ +-+ +-+-+ + + +
| |   | | |     | | |     | | | |
+ + +-+ + + +-+-+ +-+-+-+ +-+ + +
| | | | | | |       |   |     | |
+ + +-+-+ +-+ +-+-+ +-+-+-+-+-+ +
| |         |  G  |             |
+ + +-+-+-+-+ + + + +-+-+-+-+-+ +
|           | |   |             |
+ +-+-+-+ +-+ +-+-+ +-+-+-+-+ + +
| | | | | | |       |   |     | |
+ + +-+ + + +-+-+-+-+-+-+ +-+ + +
| | | | | |     | | |     | | | |
+ +-+ + + +-+-+-+ +-+ +-+-+ + + +
|   | | |       |     |     | | |
+ +-+ + +-+-+-+-+-+-+-+ +-+-+ + +
| | | |                 |     | |
+ + + +-+-+-+-+-+-+-+-+-+ +-+-+ +
| | |                     |     |
+ +-+-+-+ +-+-+ +-+-+-+-+ + +-+-+
|     | | |   | | |       | |   |
+-+-+ +-+ +-+-+ +-+ +-+-+-+ +-+-+
|                               |
+-+-+-+-+-+-+-+-+-+-+-+-+-+-+-+-+
