+-+-+-+-+-+-+-+-+-+-+-+-+-+-+-+-+
|       | |   |         |       |
+-+-+-+ + +-+ + +-+ +-+-+ +-+ + +
|     | | |   | | |       | | | |
+ +-+ + + + + + +-+-+-+-+-+-+ + +
| | | | | | | |     |   |     | |
+ + + + +-+ + + +-+ +-+-+ +-+ + +
| | |       |   | |     | | |   |
+ + + +-+-+ +-+ +-+-+-+ + +-+ + +
| | | |   | | | |     | |     | |
+ +-+ +-+-+-+ + + +-+ + +-+-+ + +
|           | |   | |   | | | | |
+ +-+-+-+ + + +-+-+ +-+-+ +-+ + +
|   |   | | | |                 |
+ + + +-+ + + +-+-+-+-+-+-+-+-+ +
| | | |   | | |G  |     |       |
+ + + +-+ + + + + + +-+ + +-+-+ +
|   |   | | | |   | | | | |   | |
+ +-+-+-+ + +-+ +-+ + + + +-+-+ +
|   |     | |       | | | |     |
+ + + +-+-+ + +-+-+-+-+ + + +-+ +
| | |       |         |         |
+ + +-+-+ +-+-+-+-+-+ + +-+-+-+ +
| |       | | | | | | | | |     |
+ +-+-+-+ +-+ + + + + + + + +-+-+
| |           | | | | | | |     |
+ + +-+-+-+-+-+ + +-+ + + + +-+ +
| | | |       | |   | | | | | | |
+ + +-+ + +-+ + +-+ + +-+-+ + + +
| |     | | | |   | |       | | |
+ +-+-+-+ + + +-+-+ +-+-+ +-+-+ +
|         | |                   |
+-+-+-+-+-+-+-+-+-+-+-+-+-+-+-+-+
