+-+-+-+-+-+-+-+-+-+-+-+-+-+-+-+-+
|       |               |   |   |
+-+-+-+ + +-+-+-+ +-+-+ +-+-+ + +
|   | | |         |   |       | |
+ + + + + +-+-+ +-+-+-+-+-+-+-+ +
| | | |         |       |   | | |
+ + +-+ +-+-+-+ + +-+-+ + + + + +
| |               |     | | |   |
+ + +-+-+-+-+-+-+ + +-+ + + + + +
| |                 | | | | | | |
+ +-+-+-+ +-+ +-+-+-+-+ + + + + +
|   |       | |       |   |   | |
+ + + +-+-+ + + +-+-+ +-+-+-+-+ +
| | | |   | |         | |     | |
+ + + +-+-+ + +-+-+-+-+-+ +-+ + +
| |   |   | | |G  |     | | | | |
+ +-+ + + + + + + + +-+ + +-+ + +
| | | | |   | |   | | | |       |
+ +-+ + + +-+ +-+ + +-+ +-+-+-+ +
| |   | | |     | |   |       | |
+ + + + + + +-+ + +-+ +-+ +-+ + +
|   | | | |     |   |   | | | | |
+ + + + + +-+-+-+ +-+-+ + +-+ + +
| | |   |     |         |   |   |
+ + +-+ +-+-+ + +-+-+-+-+ + + + +
| |   |       |       | | | | | |
+ + + +-+-+-+-+-+-+-+ + + + + + +
|   | |   |           | | |     |
+-+ + +-+-+ +-+-+-+-+ +-+ +-+-+-+
| | |     |         |           |
+-+ +-+-+ +-+-+-+-+ +-+-+-+-+-+ +
|                               |
+-+-+-+-+-+-+-+-+-+-+-+-+-+-+-+-+
