+-+-+-+-+-+-+-+-+-+-+-+-+-+-+-+-+
|         |       |             |
+-+-+-+-+ + +-+-+ + +-+-+-+-+-+ +
|               |         |   | |
+ +-+-+-+-+-+-+ + +-+ +-+ + + + +
| |           | | |     |   |   |
+ + +-+-+-+-+ + + + +-+ +-+-+-+ +
| |         | | | | |   |       |
+ +-+ +-+-+ + + + +-+ +-+ +-+ + +
|   | |   | | | | |   |     | | |
+-+ + + + + + + + + + + +-+ + + +
|   | | | | |   |   | | |     | |
+ + + + + + +-+-+-+ + +-+-+-+ +-+
| | | | | |   |     |     |     |
+ + + + + + + +-+-+-+-+ + + +-+ +
| | | | | | | |G      | | | |   |
+ + + + + + + + + +-+ + + + +-+ +
| | | | | | | |   | | | | |     |
+ + + + + + + +-+-+ + + + +-+ + +
| |   | | | |       | | |   | | |
+ +-+-+ + + + +-+-+-+ + + + + + +
|       |   | |       | | | | | |
+ +-+-+-+ +-+ + +-+ + + + + + + +
|   |   | |   | |   | | | | | | |
+ + + + + + + + + +-+ + + + + + +
| | | | | | | | |   | | | | | | |
+ + + + + + + + +-+ + + + + + + +
| | | | | | |   |   | | | | | | |
+ + + + + + +-+-+ +-+ + + + + + +
| |   |             | |   |   | |
+ +-+-+ +-+-+-+-+-+ + +-+-+-+-+ +
|                   |           |
+-+-+-+-+-+-+-+-+-+-+-+-+-+-+-+-+
