+-+-+-+-+-+-+-+-+-+-+-+-+-+-+-+-+
|                   | |   | |   |
+-+-+ + +-+ +-+-+ + +-+ + +-+ + +
|   | |       |   |     |     | |
+ + + + + +-+ + +-+-+-+-+-+-+-+ +
| | | | |       |             | |
+ + + + +-+-+-+ +-+-+ +-+-+-+ + +
| | |             |     |     | |
+ + + +-+-+-+-+-+ + +-+ + + +-+ +
| |                 |   | | |   |
+ + +-+-+ +-+-+-+-+-+-+ + + + + +
| |     |   | |       |   |   | |
+ +-+ +-+-+ + + +-+-+ +-+ +-+-+ +
|   | | | | | |   | |   | |   | |
+ +-+ +-+-+ + +-+-+-+-+ + + + + +
|   |     | | |G  |     | | | | |
+ + + + + + + + + + +-+ +-+ + + +
| | | | |   | |   | | | |   | | |
+ + + + + +-+ +-+ + + + + +-+ + +
| |   | | |   | | |   | | |   | |
+ +-+-+ +-+ +-+-+ +-+-+ + + +-+ +
| |   | |       |   |     | |   |
+ + + + + +-+-+ + +-+ +-+ + + + +
|   |   |     |       | | | | | |
+ + +-+ + +-+-+-+-+-+-+-+ + + + +
| |   | |         |       |   | |
+ + + +-+-+-+-+-+ + +-+-+-+ + + +
| | |   |         |       | |   |
+ + +-+ +-+ +-+-+-+-+-+-+ +-+ + +
| | | |   |                 | | |
+ + + +-+ +-+-+-+ +-+-+-+-+ + + +
|                               |
+-+-+-+-+-+-+-+-+-+-+-+-+-+-+-+-+
