+-+-+-+-+-+-+-+-+-+-+-+-+-+-+-+-+
|     |             |           |
+-+-+ +-+ +-+-+-+-+ +-+-+-+-+ + +
|     | |                   |   |
+ +-+-+-+ +-+-+ +-+-+-+-+-+ +-+-+
| | |     |   |           |     |
+ + + +-+-+-+-+-+-+-+-+-+ +-+-+ +
| | | |                 |     | |
+ +-+ + +-+-+-+-+-+-+-+ +-+-+ + +
|   | | |     |       |     | | |
+ +-+ + + +-+-+-+ +-+ +-+-+ + + +
| |   | | |     | | |     | | | |
+ +-+ + + + +-+-+ +-+-+-+ +-+ + +
| | | | | | |       |   |     | |
+ + + +-+ +-+ +-+-+ +-+-+-+-+-+ +
| | |       | |G  |             |
+ +-+ +-+-+-+ + + + +-+-+ +-+-+-+
|           |     |             |
+ +-+-+-+ +-+ +-+-+ +-+-+-+-+ + +
| |     | | |       |   |     | |
+ + +-+ + + +-+-+-+-+-+-+ +-+ + +
| | | | | |     | | |     | | | |
+ +-+ + + +-+-+-+ +-+ +-+-+ + + +
|   | | |     |       |     | | |
+ +-+ + +-+-+-+-+-+-+-+ +-+-+ + +
| | | |                 |     | |
+ + + +-+-+-+-+-+-+-+-+-+ +-+-+ +
| | |                     |     |
+ +-+-+-+-+ +-+ +-+-+-+-+ + +-+-+
|       | | | | |     |   | |   |
+-+-+-+ +-+ +-+ +-+-+-+ +-+ +-+-+
|                               |
+-+-+-+-+-+-+-+-+-+-+-+-+-+-+-+-+
