+-+-+-+-+-+-+-+-+-+-+-+-+-+-+-+-+
|               | |             |
+-+-+-+ +-+ +-+ + + +-+-+ +-+-+ +
|     | | | | | | | | | |     | |
+-+-+-+ +-+-+-+ +-+ +-+-+-+-+ + +
|         | |                 | |
+ +-+-+-+-+ +-+-+-+-+ +-+-+-+-+ +
| |         |       | | | |   | |
+ +-+-+ +-+ +-+-+-+-+ +-+-+ + + +
|         | |             | | | |
+ +-+-+-+-+ +-+-+-+-+-+-+ + + + +
| |       |         |   | | | | |
+ +-+-+-+-+ +-+-+-+-+ + + + + + +
|         | |       | | | | | | |
+ +-+-+ + + + +-+-+ + + + + + + +
| |     | | | |G  |   | | | |   |
+ + +-+ + + + + + +-+-+ + + +-+ +
| | | | |   | |   |   | |   | | |
+ + +-+ + + + + +-+ + + +-+-+-+ +
|       | | |       | |         |
+-+-+-+-+ + +-+-+-+-+ +-+-+-+-+ +
|         | |         |       | |
+ +-+-+-+ +-+-+-+-+-+ +-+-+-+-+ +
|         |         | |         |
+ +-+-+ +-+ +-+-+-+-+ +-+-+-+-+ +
|     | | | |       | |       | |
+ +-+-+ +-+ +-+-+-+-+ +-+-+-+-+ +
|           |       | |         |
+ +-+-+-+ +-+-+-+ +-+ +-+ +-+-+ +
| | |     |     | | | | | |   | |
+ +-+ +-+-+-+-+-+ +-+ +-+ +-+-+ +
|                               |
+-+-+-+-+-+-+-+-+-+-+-+-+-+-+-+-+
