+-+-+-+-+-+-+-+-+-+-+-+-+-+-+-+-+
|         |                     |
+-+-+-+ +-+-+ +-+-+-+ +-+-+ +-+ +
|     | |   | |     | |     | | |
+-+-+-+ +-+ + +-+-+-+ + +-+ +-+ +
|         | |         | |     | |
+ +-+-+-+-+ +-+ +-+-+-+ +-+-+ + +
| |               |         | | |
+ + +-+ +-+-+-+-+ +-+-+-+-+ + + +
| | |           |           |   |
+ + +-+-+-+ +-+-+ +-+-+ +-+-+ + +
| |       | |       | | |     | |
+ + + + +-+ + +-+-+ + + +-+ + + +
| | | | |   |       | |   | | | |
+ +-+ + +-+-+ +-+-+-+ +-+-+ + + +
|     | | |   |G  | |       | | |
+ +-+-+ + +-+-+ + + +-+-+-+-+ + +
|     | | |   |   | |           |
+ +-+ + +-+ + + +-+-+ +-+-+ +-+-+
| | | | |   | |       |   | |   |
+ + + + +-+ + +-+-+-+ + +-+ +-+ +
| | |     | |         | |     | |
+ + +-+-+-+ +-+-+-+-+-+ +-+-+ + +
| |   |                     | | |
+ +-+-+ +-+-+-+-+-+ +-+-+-+ + + +
| |                         | | |
+ +-+-+-+-+ +-+ +-+-+-+ +-+-+ + +
|         | |         | |     | |
+ +-+-+ +-+ + +-+-+ +-+ + +-+ + +
| |   | |   | |   | |   | | | | |
+ +-+-+ +-+-+ +-+-+ +-+-+ +-+ + +
|             |   |           | |
+-+-+-+-+-+-+-+-+-+-+-+-+-+-+-+-+
