+-+-+-+-+-+-+-+-+-+-+-+-+-+-+-+-+
|           | |                 |
+-+-+-+ +-+ +-+ +-+-+-+ +-+-+-+ +
|       | |     |             | |
+ +-+-+-+-+ +-+-+ +-+-+-+-+-+ + +
| |         |         |     | | |
+ + +-+-+-+-+-+-+-+-+ +-+-+ + + +
| |           |   |   |   | | | |
+ + +-+ +-+-+ +-+-+ +-+-+ + + + +
| | | |       |     | | | | | | |
+ + + + +-+-+-+-+-+ + +-+-+-+ + +
| | | | |   |     | |   |   | | |
+ + +-+ + +-+-+-+-+ +-+-+ + +-+ +
|   |   | | |             | |   |
+-+ + +-+ + +-+-+-+-+-+-+-+ + +-+
| | | | | | |  G  |         | | |
+ + + + + + + + + + +-+-+-+-+ + +
| |   | | | | |   |         | | |
+-+ + +-+ + + +-+-+-+-+-+-+ + +-+
|   |   | | |             | |   |
+ + +-+ + +-+-+-+-+ +-+-+ + +-+ +
| | | | |   |     | |   |     | |
+ + + + +-+-+-+-+-+ + +-+-+-+ + +
| | | |       |     | | | | | | |
+ + +-+-+-+-+ +-+-+ +-+-+ + + + +
| | |         |   |   |   | | | |
+ +-+-+ +-+-+ +-+-+-+ +-+-+ + + +
| |         |   |     |     | | |
+ + +-+-+-+ +-+-+ +-+-+-+-+-+ + +
| |     | |     |             | |
+ + +-+ +-+ +-+ +-+-+-+ +-+-+-+ +
|   | |     | |                 |
+-+-+-+-+-+-+-+-+-+-+-+-+-+-+-+-+
