+-+-+-+-+-+-+-+-+-+-+-+-+-+-+-+-+
|                 |           | |
+-+-+-+-+ +-+ +-+-+-+-+ +-+-+ + +
|       | | | |       | |   | | |
+-+-+-+-+ + + +-+-+-+-+ + +-+ +-+
|         | |           | |     |
+ +-+-+-+-+ +-+-+-+ +-+-+ +-+-+ +
| |           |       |       | |
+ + +-+-+-+-+-+ +-+-+ +-+-+-+ + +
| |       |   |       |       | |
+ + +-+-+-+ + +-+-+-+-+-+ +-+-+ +
| | |     | |           | |     |
+ + + +-+ + +-+-+-+-+-+ + +-+ + +
| | | | | |         | | |   | | |
+ +-+ + + +-+-+-+ + + + +-+-+ + +
|     | |     |G  | | |       | |
+ +-+-+-+-+-+ + + +-+-+-+-+-+-+ +
|     | |     |               | |
+ +-+ + + +-+-+-+-+ +-+ +-+-+ + +
| | | | | |   | | | | | |   | | |
+ + + +-+ + +-+ +-+ +-+ + +-+ + +
| | |     | |           | |   | |
+ + +-+-+-+ + +-+-+-+-+-+-+-+ + +
| |         | |         |     | |
+ + +-+-+-+-+-+-+-+-+-+-+ +-+ + +
| |       |               |   | |
+ +-+-+-+ + +-+-+-+-+-+ + +-+-+ +
|       | | |           |       |
+ +-+-+ +-+ + +-+-+-+-+ + +-+ + +
| |   | |   | |       | | | | | |
+ +-+-+ +-+-+ +-+-+-+-+ + +-+ + +
|                               |
+-+-+-+-+-+-+-+-+-+-+-+-+-+-+-+-+
