+-+-+-+-+-+-+-+-+-+-+-+-+-+-+-+-+
|       |                       |
+-+-+-+ + +-+ +-+-+-+-+ +-+-+ + +
|     | |   | |       | |   | | |
+-+-+-+ +-+ + +-+-+-+-+ + + + + +
|         | |           | |     |
+ +-+-+-+-+ +-+ +-+-+-+-+ +-+-+ +
| |           |               | |
+ + +-+ +-+-+ +-+-+ +-+-+-+-+ + +
| | |       |                 | |
+ + +-+-+-+ +-+-+-+-+ +-+ +-+-+ +
| |       | |           | |     |
+ + +-+ + + +-+ +-+-+-+-+ +-+ + +
| |   | | |   |     | | |   | | |
+ +-+-+ + +-+-+-+-+ +-+ +-+-+ + +
|       |     |G  |           | |
+ +-+-+-+-+-+ + + +-+-+-+-+-+-+ +
|       |     |   |             |
+ +-+-+ + +-+-+ +-+ +-+ +-+-+ + +
| |   | | |   |     | | |   | | |
+ + +-+ + + + +-+-+-+-+ + +-+ + +
| | |     | |           | |     |
+ + +-+-+-+ +-+-+-+-+-+-+ +-+-+ +
| |         |         |       | |
+ +-+ +-+-+-+ +-+-+-+ +-+-+-+ + +
| |                 |         | |
+ +-+-+-+-+ +-+-+ +-+-+-+ +-+-+ +
|         | |           | |     |
+-+-+-+ +-+ + +-+-+-+-+ + +-+ + +
|     | |   | |       | |     | |
+-+-+-+ +-+-+ +-+-+-+-+ +-+-+ + +
|                   |         | |
+-+-+-+-+-+-+-+-+-+-+-+-+-+-+-+-+
