+-+-+-+-+-+-+-+-+-+-+-+-+-+-+-+-+
|                 |           | |
+-+-+-+ +-+-+ +-+-+-+-+ +-+-+ + +
|     | |   | |       | |   | | |
+-+-+-+ +-+ + +-+-+-+-+ + +-+ +-+
|         | |           | |     |
+ +-+-+-+-+ +-+-+-+ +-+-+ +-+-+ +
| |           |       |       | |
+ + +-+-+-+-+-+ +-+-+ +-+-+-+ + +
| |           |       |       | |
+ + +-+-+-+ +-+-+-+-+-+-+ +-+-+ +
| | |     | |           | |     |
+ + + +-+ + +-+ +-+-+-+ + +-+ + +
| | | | | |   |       | |   | | |
+ +-+ + + +-+-+-+-+-+ + +-+-+ + +
|     | |     |G  |   |       | |
+ +-+-+-+-+-+ + + + +-+-+-+-+-+ +
|     | |     |     | |       | |
+ +-+ + + +-+-+-+-+ + + + +-+ + +
| | | | | |   | | | | | |   | | |
+ + + +-+ + +-+ +-+ +-+ + +-+ + +
| | |     | |           | |     |
+ + +-+-+-+ + +-+-+-+-+-+ +-+-+ +
| |         | |         |     | |
+ + +-+-+-+-+ +-+-+-+-+-+ +-+ + +
| |       |               |   | |
+ +-+-+-+-+ +-+-+-+-+ +-+ +-+-+ +
|         | |           | |     |
+ +-+-+ +-+ + +-+-+-+-+ + +-+ + +
| |   | |   | |       | |   | | |
+ +-+-+ +-+-+ +-+-+-+-+ +-+-+ + +
|                               |
+-+-+-+-+-+-+-+-+-+-+-+-+-+-+-+-+
