+-+-+-+-+-+-+-+-+-+-+-+-+-+-+-+-+
|             |   |             |
+-+-+-+ + + + +-+-+ + + +-+ +-+ +
|     | | | |       | | | | | | |
+-+-+-+ + + +-+-+-+-+ + +-+ + + +
|   | | | |     |     |     | | |
+ + +-+ + +-+-+ + +-+-+ +-+-+ + +
| |                     | |   | |
+ +-+ +-+-+-+-+-+-+-+-+-+-+-+-+ +
|               |       |       |
+ +-+-+ + +-+-+-+-+-+-+ + +-+-+ +
|     | | |   |   |   | | |   | |
+ +-+ + + + +-+-+-+-+ + + + + + +
|   | | | | |       | | | | |   |
+ + + + + +-+ +-+-+ +-+ +-+ + +-+
| | | |   | | |G  |     | | | | |
+ + + +-+ + + + + + +-+ + + +-+-+
| | | |   | | |   | | | | | | | |
+ + + + + +-+ + +-+ +-+ +-+ + +-+
|   | | | | |       | |   | |   |
+ +-+ + + + +-+-+-+-+ +-+ + + + +
|     | | |   |   |   | | |   | |
+ +-+-+ + +-+-+-+-+-+-+-+ +-+-+ +
|       |       |               |
+-+ + +-+-+-+-+-+-+-+-+ +-+-+-+ +
| | | | |         |   | | |   | |
+-+ + +-+ +-+-+ + +-+-+ +-+-+ + +
|     | | |     |     |     | | |
+ +-+-+ + + +-+-+-+-+ + +-+ + + +
| |     | | |       | | | | | | |
+ +-+-+-+ + + +-+-+ + + +-+ +-+ +
|                               |
+-+-+-+-+-+-+-+-+-+-+-+-+-+-+-+-+
