+-+-+-+-+-+-+-+-+-+-+-+-+-+-+-+-+
|     |                     |   |
+-+-+ + +-+-+ +-+-+-+-+-+-+ + + +
|   | | | |           |   | |   |
+ + + + + + +-+-+-+-+ +-+-+ + + +
|   | | | | |   |   |     | |   |
+-+-+ + +-+ + + +-+-+-+-+ + + + +
|     |     | | |       | | |   |
+ +-+-+ +-+ + + + +-+-+ + + + + +
| | |   | | | | | |   | |   |   |
+ + + + + + + + + + + + + + +-+ +
| | | | | |   |   |   | | |   | |
+ +-+ + + + +-+-+-+-+ + + + + + +
|   | | | | |       | |   | | | |
+ +-+ + +-+ + +-+-+ +-+-+-+ + +-+
| |   |     |  G  |         |   |
+ + + +-+-+ + + + +-+-+ +-+-+-+ +
| | | |   | | |   |         |   |
+ + + + +-+ + +-+-+ +-+-+-+ + +-+
|   | | | | |       | |   | | | |
+ + + + + + +-+-+-+-+ + + + + + +
| | |   | |   |   |   | | |   | |
+ + + + + + + + + + + + + + +-+ +
| |   | | | | | | |   | |   |   |
+ +-+-+ +-+ + + + +-+-+ + + + + +
|     |     | | |       | | |   |
+-+-+ + +-+ + + +-+-+-+-+ + + + +
|   | | | | |   |   |     | |   |
+-+-+ + + + +-+-+-+-+ +-+-+ + + +
|     | | |           |   | |   |
+ +-+-+ +-+-+ +-+-+-+-+-+-+ + + +
|                           |   |
+-+-+-+-+-+-+-+-+-+-+-+-+-+-+-+-+
