+-+-+-+-+-+-+-+-+-+-+-+-+-+-+-+-+
|                   |           |
+-+-+-+ +-+ +-+ +-+-+-+-+ +-+-+ +
|     | | | | | |       |     | |
+-+-+-+ +-+-+-+ +-+-+-+-+-+-+ + +
|         | |                 | |
+ +-+-+-+-+ +-+-+-+-+ +-+-+-+-+ +
| |                 | |   |   | |
+ +-+-+ +-+ +-+-+-+-+ +-+-+ + + +
|         | |             | | | |
+ +-+-+-+-+ +-+-+-+-+-+-+ + + + +
| |       |         | | | | | | |
+ +-+-+-+-+ +-+-+-+-+ +-+ + + + +
|         | |       |   | | | | |
+ +-+ +-+ + + +-+-+ + + + + + + +
| |     | | |  G  | | | | | | | |
+ +-+-+ + + + + + + + + + + + + +
| |   | |   | |   |   | |   |   |
+ +-+-+ + + + +-+-+-+-+ +-+-+-+ +
|         | |       | |         |
+ +-+-+-+ + + +-+-+-+ +-+-+-+-+ +
| |     | | |         |       | |
+-+-+-+-+ +-+-+-+-+-+ +-+-+-+-+ +
|         |         | |         |
+ +-+-+-+-+ +-+-+-+-+ +-+-+-+-+ +
| |       | |         |       | |
+ +-+-+-+-+ +-+-+-+-+ +-+-+-+-+ +
|               |   | |         |
+ +-+-+-+ +-+-+-+ +-+ +-+ +-+-+ +
| | |     |     | | | | | |   | |
+ +-+ +-+-+-+-+-+ +-+ +-+ +-+-+ +
|                               |
+-+-+-+-+-+-+-+-+-+-+-+-+-+-+-+-+
