+-+-+-+-+-+-+-+-+-+-+-+-+-+-+-+-+
|         |   |                 |
+-+-+ +-+ +-+-+ +-+-+-+-+ +-+-+ +
|   | | |       |       | |   | |
+ + + + +-+-+-+ + + +-+-+ +-+ + +
|   | |       | |   |       | | |
+-+-+ +-+-+-+-+ + + + +-+-+ + + +
|               |   | |     | | |
+ +-+-+-+ +-+-+ + + + + +-+ + + +
| |     | |   | |   | | | | | | |
+ + + + + +-+-+ +-+-+ + + + +-+ +
| |     | |           | | |     |
+ + + + + + +-+-+-+-+-+ + + +-+ +
| |     | | |         | | | | | |
+ +-+-+-+ + + +-+-+ + + +-+ + + +
|           | |G  |   |     | | |
+ +-+ +-+-+-+ + + + +-+-+-+-+ + +
| | | |       |   | |     |   | |
+ + + +-+-+-+-+-+ + + +-+ + + + +
| | |           | | | | | |   | |
+ + +-+-+ +-+-+ + +-+ + + +-+-+ +
| |     | |   | |     | |       |
+ +-+-+-+ +-+-+ +-+-+ + + +-+-+ +
|               |   | | | |   | |
+ +-+ +-+-+-+-+ + + + +-+ + + + +
| | | |       | |   |     |   | |
+ + + +-+-+-+ + + + + +-+ + + + +
| | |       | | |   | | | |   | |
+ + +-+-+-+ + + + + + + + + + + +
| |       | | | |   | | | |   | |
+ +-+-+-+-+ +-+ +-+-+-+-+ +-+-+ +
|                               |
+-+-+-+-+-+-+-+-+-+-+-+-+-+-+-+-+
