+-+-+-+-+-+-+-+-+-+-+-+-+-+-+-+-+
|             |   |             |
+-+-+-+ + +-+ +-+-+ +-+ +-+ +-+ +
|     | | | |       | | | | | | |
+-+-+-+ + + +-+-+-+-+ + +-+ + + +
|   | | | |   | |     |     | | |
+ + +-+ + +-+-+ +-+-+-+ +-+-+ + +
| |       |             | |   | |
+ +-+ +-+-+ +-+-+ +-+-+ +-+-+-+ +
|                       |       |
+ +-+-+ + +-+-+-+-+-+-+-+ +-+-+ +
| |   | | |   |   |   | | |   | |
+ +-+ + + + +-+-+-+-+ + + + + + +
|   | |   | |       | | | | |   |
+ + + + + + + +-+-+ +-+ +-+ + +-+
| | | | | | | |G  |     | | | | |
+ + +-+ + +-+ + + + +-+ + + + +-+
| | | | | | | |   | | | | | | | |
+ + + + + + + + +-+ +-+ +-+ + +-+
|   | |   | |       | |   | |   |
+ +-+ + + + +-+-+-+-+ + + + + + +
| |   | | |   |   |   | | |   | |
+ +-+-+ + +-+-+-+-+-+-+-+ +-+-+ +
|         |           |         |
+-+ + +-+-+ +-+-+ +-+ + +-+-+-+ +
| | | | |             | | |   | |
+-+ + +-+ +-+-+-+-+-+-+ +-+-+ + +
|     | | |           |     | | |
+ +-+-+ + + +-+-+-+-+ + +-+ + + +
| |     | | |       | | | | | | |
+ +-+-+-+ + + +-+-+ + + +-+ +-+ +
|                               |
+-+-+-+-+-+-+-+-+-+-+-+-+-+-+-+-+
