+-+-+-+-+-+-+-+-+-+-+-+-+-+-+-+-+
|                   |   |       |
+-+-+-+-+-+-+-+-+ + + + + +-+ + +
|     |           | | |   |   | |
+ +-+ +-+ +-+-+-+-+ + +-+ +-+ + +
|   |   |           |         | |
+-+-+ +-+ +-+ +-+ +-+-+ +-+-+ + +
|   | |         |     |       | |
+ +-+ + +-+ +-+-+ + +-+ +-+-+-+ +
| |   |   |       |           | |
+ + + + +-+ +-+ +-+-+-+-+-+-+ + +
|   |   |   |   |       |   | | |
+-+ + + +-+ +-+-+ +-+ + + + + + +
|     |   |         | | | | | | |
+ +-+ + +-+ + +-+-+ + + + + + + +
|       |   | |G    |     |   | |
+-+ +-+ +-+ + + + +-+-+-+-+-+ + +
|     |       |   |         | | |
+ +-+ +-+ +-+ +-+-+ +-+-+ +-+ + +
|   | | |         | |   |   | | |
+-+ + + +-+ +-+-+-+ + + + +-+ + +
| |   |   |         | | |     | |
+ +-+ + + +-+-+-+ +-+ + +-+-+ + +
|   |   |   |   | |   | |     | |
+ + +-+ +-+ +-+ + + + + + +-+-+ +
| |   |   | |   | | |         | |
+ +-+ +-+ +-+ +-+ + +-+-+-+ +-+ +
|   |       | |   |       |   | |
+-+ +-+ +-+-+ +-+ +-+ + +-+-+ + +
|   |           |   | |     | | |
+-+ + +-+-+ +-+ + +-+ +-+ + +-+ +
|   |   |   |     |     | |     |
+-+-+-+-+-+-+-+-+-+-+-+-+-+-+-+-+
