+-+-+-+-+-+-+-+-+-+-+-+-+-+-+-+-+
|   |   |     |       |         |
+-+ + + + + + + + + + +-+-+-+ + +
|     |   | | | | | |       | | |
+ +-+ +-+ + + + + + + +-+-+-+ + +
|       |   | | | | | |       | |
+ +-+-+ + + + + + + + +-+-+-+ + +
|   |   | | | |   | |       | | |
+-+ +-+-+ +-+ + + + + +-+-+-+ + +
|         |     |   | |       | |
+ +-+ +-+-+ + + + + + +-+-+-+ + +
|       |   | | | | |       | | |
+ +-+-+-+ +-+-+ + + + +-+-+-+ + +
|           |     | | |       | |
+-+-+-+-+ +-+ +-+-+-+ +-+-+-+ + +
|             |G  | |       | | |
+ +-+-+ +-+-+ + + + + +-+-+-+ + +
|             |   | |         | |
+ +-+-+-+ +-+-+ +-+ +-+-+-+-+-+ +
|             |               | |
+ +-+-+-+-+-+-+-+-+ +-+ +-+-+-+ +
|                 | |     |     |
+-+ +-+ +-+ +-+ + + + +-+ +-+-+ +
| | | | | | | | | |   |       | |
+ + + + + + + + + + + + +-+ + + +
| | | | | | | | | | |   |   | | |
+ + + + + + + + + + +-+ + +-+ + +
| | | | | | | | | | | |   |     |
+ +-+ +-+ +-+ +-+ + + + +-+ +-+ +
|                 | | |     | | |
+ +-+-+-+-+-+-+-+-+-+ +-+-+ +-+ +
|                               |
+-+-+-+-+-+-+-+-+-+-+-+-+-+-+-+-+
