+-+-+-+-+-+-+-+-+-+-+-+-+-+-+-+-+
|     |                         |
+-+-+ + +-+-+-+-+-+-+ +-+-+-+ + +
|   | |             |         | |
+ + + +-+ +-+-+-+-+-+-+-+-+-+-+ +
| | | |     |                 | |
+ + + + +-+-+-+ +-+-+ +-+ + + + +
| |   |       |           | | | |
+ + + +-+ +-+ + +-+-+ +-+-+ + + +
| | |   |   | |           | | | |
+ + + + +-+ + + +-+-+-+-+-+ + + +
| |   |       |           | | | |
+ + +-+-+-+-+-+-+-+-+-+-+ + + + +
| | | | | |             | | | | |
+ + + + + + + +-+-+-+-+ + + + + +
|   |   |   | |G  |     | | | | |
+-+-+ + + + + + + + + + + + + + +
|     |   | |     | | | | | | | |
+ + + +-+ + + +-+-+ + + + + + + +
| | | | |   | |     | | | | | | |
+ + + + +-+ + + +-+ + + + + + + +
| | | |   |   |         | |   | |
+ + + + + +-+-+-+-+-+ +-+ + +-+ +
| |   | | |         |     | | | |
+ + +-+ + + +-+-+ + + +-+ + + + +
| | | | | |       | |     | |   |
+ + + + + + +-+ +-+ +-+-+-+ + + +
| | |   |   |     |         | | |
+ + + + + +-+ +-+-+-+ +-+-+-+ + +
| |   | |           |           |
+ +-+ +-+-+ +-+-+-+-+-+ +-+-+ + +
|             |               | |
+-+-+-+-+-+-+-+-+-+-+-+-+-+-+-+-+
