+-+-+-+-+-+-+-+-+-+-+-+-+-+-+-+-+
|           | |                 |
+-+-+-+ +-+ +-+ +-+-+ +-+-+-+-+ +
|       | |     |             | |
+ +-+-+-+-+ +-+-+ +-+-+-+-+-+ + +
| |         |         |     | | |
+ + +-+-+-+-+ +-+-+-+ +-+-+ + + +
| |           | | |   |   | | | |
+ + + + +-+-+ + +-+ +-+-+ + + + +
| | | | | |   |     | | | | | | |
+ + + + + +-+ +-+-+ + +-+-+-+ + +
|   | | | | |   | | |   |   | | |
+ + + + + + +-+-+-+ +-+-+ + +-+ +
| | |   | | |     |       | |   |
+ + + +-+ + + +-+-+-+-+-+-+ + + +
| |   | | | |  G  |         | | |
+ +-+-+ +-+ + + + + +-+-+-+-+ + +
| |   | | | | |   |         | | |
+ + + +-+ + + +-+-+-+-+-+-+ + + +
| | | |   | |             | |   |
+ + + + + + +-+-+-+ +-+-+ + +-+ +
| | | | | | |   | | |   |     | |
+ + + + + +-+ + +-+ + +-+-+-+ + +
|   | | |     |   | | | | | | | |
+ + + + +-+-+ + +-+ +-+-+ + + + +
| | |       | | | |   |   | | | |
+ + +-+-+-+-+ + +-+-+ +-+-+ + + +
| |       |   |       |     | | |
+ +-+-+-+-+-+-+-+ +-+-+-+-+-+ + +
| |     | |     |             | |
+ + +-+ +-+ +-+ +-+-+-+ +-+-+-+ +
|   | |     | |                 |
+-+-+-+-+-+-+-+-+-+-+-+-+-+-+-+-+
