+-+-+-+-+-+-+-+-+-+-+-+-+-+-+-+-+
|   |   |     |       |         |
+-+ + + + + + + + +-+ + +-+-+-+ +
|     |   | | | |   | |       | |
+ +-+-+-+ + + + + + + + +-+-+-+ +
|   |     | | | | | | | |       |
+-+ +-+-+ + + + + + + + +-+-+-+ +
|       | | | | | | | |       | |
+-+ +-+-+ + + + + + + + +-+-+-+ +
|           |   | | | | |       |
+ +-+-+-+ +-+ + + + + + +-+-+-+ +
|         |   | | | | |       | |
+ +-+-+-+-+ +-+ + + + + +-+-+-+ +
|           |       | | |       |
+-+-+-+-+ +-+ +-+-+-+ + +-+-+-+ +
|             |G  | | |       | |
+-+-+-+-+-+-+ + + + + + +-+-+-+ +
|             |   | |   |       |
+ + +-+-+-+-+ + +-+ +-+-+-+-+-+ +
| |           |         | | | | |
+ +-+-+-+-+-+-+-+-+ +-+ + + + + +
|                 | |     | | | |
+-+-+-+-+-+-+-+-+ + + +-+ + + + +
|                 |   | |     | |
+ + +-+ +-+ +-+ +-+-+ +-+ +-+ + +
| | | | | | | | | |       |   | |
+ + + + + + + + + +-+-+ +-+-+ + +
| | | | | | | | | |     | |     |
+ + + + + + + + + +-+-+ + + +-+ +
| | | | | | | | | |         | | |
+ +-+ +-+ +-+ +-+ +-+-+-+-+ +-+ +
|                               |
+-+-+-+-+-+-+-+-+-+-+-+-+-+-+-+-+
