+-+-+-+-+-+-+-+-+-+-+-+-+-+-+-+-+
|       |                   |   |
+-+-+-+ + +-+-+-+ + +-+-+ +-+ + +
|   | |   |       |     | |   | |
+ + +-+ + + +-+-+-+-+-+ + + +-+ +
| | |   | |           | |   |   |
+ + + + + +-+ +-+-+ + + +-+-+ + +
| |   | |           |     |   | |
+ + +-+ + + +-+-+-+ +-+-+ + + + +
|   |   | |         |     | | | |
+ +-+ +-+ +-+ +-+-+-+ + +-+ + + +
|       |   |         |   | |   |
+ + +-+ +-+ +-+-+-+-+-+-+ + + +-+
| |   |   | |           |   | | |
+ + + + + + + +-+-+ +-+ +-+-+ + +
| | | | |   | |G  |         | | |
+ + + + +-+ + + + +-+-+-+-+ + + +
| | |   | | | |           | |   |
+ + +-+ + + + +-+-+ +-+-+ + +-+ +
|   |   |   |             |   | |
+ +-+ + + +-+-+ +-+-+-+-+ + + + +
|     |   |             |   | | |
+ +-+-+-+-+ +-+-+ +-+-+ +-+-+ + +
|         |               | |   |
+ +-+-+ + +-+-+-+-+-+-+-+ +-+ + +
| |     | |           |     | | |
+ + + + + + +-+-+ + + + +-+ + + +
|   | | | |     | | | | | | | | |
+-+ + + + +-+-+ + + + + + + + + +
| |   |       | | | |   | | |   |
+ +-+ +-+-+ + + +-+ +-+-+-+ + +-+
|           |                 | |
+-+-+-+-+-+-+-+-+-+-+-+-+-+-+-+-+
