+-+-+-+-+-+-+-+-+-+-+-+-+-+-+-+-+
|                               |
+-+-+-+-+ +-+-+-+-+-+-+-+-+ + + +
|   |       |             | | | |
+ + + +-+-+-+ +-+ +-+ +-+-+ + + +
| | | |   |   |   |   | | | | | |
+ + + + +-+-+ + +-+ +-+ + + + + +
| |   | | |   |     |   | | | | |
+ + +-+ + + +-+ + +-+ +-+ + + + +
| |     | | | | | | | |   | | | |
+ + +-+ + + +-+ + + + + +-+ + + +
| | | | | |     | |   | |   | | |
+ + + +-+ + +-+-+ +-+ + + +-+ + +
| | |   | | | |     |   | | | | |
+ + + + + + + +-+-+ +-+-+ +-+ + +
| |   | |   | |G  |           | |
+ +-+-+ + + + + + +-+-+-+-+-+-+ +
| |   | | | | |   |   |       | |
+ + + + + + + + +-+ +-+-+ +-+ + +
|   |   | | | |     |   | | | | |
+ + + +-+ + +-+-+ +-+ + + +-+ + +
| | | | | |     | |   | |   | | |
+ + +-+ + + +-+ + + + + +-+ + + +
| |     | | | | | | | |   | | | |
+ +-+-+ + + +-+ + +-+ +-+ + + + +
| |   |   | | | |       | | | | |
+ + + + +-+-+ + +-+ +-+ + + + + +
| | | |       |   |   | | | | | |
+ + + +-+ +-+ +-+ +-+ +-+ + + + +
| | |         |         |   | | |
+-+ +-+-+-+-+-+-+-+-+-+ +-+-+ + +
|                       |       |
+-+-+-+-+-+-+-+-+-+-+-+-+-+-+-+-+
