+-+-+-+-+-+-+-+-+-+-+-+-+-+-+-+-+
|         |       |     |       |
+-+-+-+ + + +-+-+ + +-+ + +-+-+ +
|       | |   |   | | | | |   | |
+ +-+-+-+ +-+ + +-+ + + + +-+ + +
|                     | |     | |
+ +-+-+-+ +-+-+-+-+-+-+ + + +-+ +
|   |   |         |     | |     |
+ + + + +-+-+-+-+ + + + + + + + +
| |   |   |   | | | | | | | | | |
+ +-+-+-+ + + + + + + + +-+ + + +
| |       | | |   |         | | |
+ + +-+-+-+ + +-+ +-+-+-+-+-+ + +
| | |       |     |           | |
+ + +-+-+-+ +-+-+-+-+-+-+-+-+-+ +
|         |   |G  |             |
+ +-+-+-+ + + + + + +-+-+-+-+-+ +
|         | | |   |           | |
+ +-+-+-+-+ + +-+ +-+-+-+-+-+ + +
| |     | |   | |   | |       | |
+ +-+ + +-+ +-+-+-+ +-+ +-+-+-+ +
|     | |   |     |   |         |
+ +-+-+ +-+ + +-+ +-+ +-+-+-+-+ +
|       | | | | | | | |   |     |
+ +-+-+-+-+ + +-+ + + + +-+ +-+-+
|     |     |     | | | |   |   |
+ +-+ + +-+-+ + +-+-+ + + +-+ + +
| |   |       | | |     |     | |
+ + +-+-+-+-+-+ + +-+ +-+ +-+-+ +
| |           | |   | | | |   | |
+ +-+-+-+-+-+ + +-+-+ +-+ +-+-+ +
|             |                 |
+-+-+-+-+-+-+-+-+-+-+-+-+-+-+-+-+
