+-+-+-+-+-+-+-+-+-+-+-+-+-+-+-+-+
|                           |   |
+-+-+ +-+-+ +-+ +-+-+-+ +-+ + + +
|     |   |     |     |   |   | |
+ +-+ + + + +-+ +-+-+ +-+ + +-+ +
| | | | | | | |   | |   |   | | |
+ + +-+ + +-+ + + + +-+ +-+ +-+ +
| |     |     | | |   |   |   | |
+ +-+-+ + +-+-+ + + + + + +-+ + +
|       | |     | | | | | |   | |
+ +-+ + + + +-+-+ + + + + + +-+ +
| | | | | |         | | | |     |
+-+ +-+ + + +-+-+-+-+ + + + +-+ +
| | | | | |             | | | | |
+ +-+ + + + +-+-+-+-+-+ + +-+ + +
|       | | | |G  |     |     | |
+ +-+-+-+ +-+ + + + +-+-+ +-+-+ +
| |     |     |   | | | | |   | |
+ + +-+ + +-+-+ +-+-+ + + + + + +
| |   | | |     |   |   | | | | |
+ +-+ + + + +-+-+ + + + + + + + +
| |   | | | |   | | | | | | |   |
+ + + + + + + + + + + + + + +-+-+
| | | | | |   | | |   | | |     |
+ + + + + + +-+ + +-+-+ + +-+-+ +
| | | |   |   |   |     |     | |
+ + + +-+ +-+ +-+ + +-+ + +-+ + +
| | |   |   |     | | | | | | | |
+ + + + +-+ +-+-+ +-+ + + + +-+ +
| | | |   |     |     |   |     |
+ + + +-+ +-+-+-+-+-+ +-+-+ +-+ +
|   |                           |
+-+-+-+-+-+-+-+-+-+-+-+-+-+-+-+-+
