+-+-+-+-+-+-+-+-+-+-+-+-+-+-+-+-+
|   |                       |   |
+-+ + +-+-+-+-+-+-+-+-+-+-+ + + +
| | |         |   |       | | | |
+-+ + +-+ + + + + + +-+ + + + + +
|   | | | | | | | | | | | | | | |
+ +-+ + + + + + + + +-+ + + + + +
| | | | | | |   |       | | | | |
+ + + + + + +-+-+-+-+-+-+ + + + +
| | | | | | |   |   |   | |   | |
+ +-+ + + + + + + + + + + + + + +
|   | | | |   |   |   | | | | | |
+ +-+ + + + +-+-+-+-+-+ + + + + +
| | | | | | |       | | | | | | |
+ +-+ + + + + +-+-+ +-+ + +-+ + +
| |   |   | |  G  |           | |
+ + +-+-+-+-+ + + + +-+-+-+-+-+ +
| | |   |   | |   |       |   | |
+ + + + + + + +-+-+ +-+ + + + + +
|   | | | | |       | | | | | | |
+ +-+ + + + +-+-+-+-+-+ + + + + +
|   | | | |   |   |   | | | | | |
+ + + + + + + + + + + + + + + + +
| |   | | | | | | | | | | | | | |
+ +-+-+ + +-+ + + + + + + + + + +
|     |   | |   |   |   | | | | |
+ +-+ +-+-+ +-+-+-+-+-+-+ + + + +
|   | | |     | |     | |   | | |
+-+ + +-+ +-+ +-+ +-+ +-+-+-+ + +
| | |     | |     | |         | |
+-+ + +-+-+-+-+-+-+-+-+-+-+-+-+ +
|                               |
+-+-+-+-+-+-+-+-+-+-+-+-+-+-+-+-+
