+-+-+-+-+-+-+-+-+-+-+-+-+-+-+-+-+
|             |   |             |
+-+-+ +-+ + + +-+-+ + + +-+ +-+ +
| | | | | | |       | | | | | | |
+ + + +-+ + +-+-+-+-+ + +-+ + + +
| | |     |     |     |     | | |
+ + +-+-+ +-+-+ + +-+-+ +-+-+ + +
| |   | |           |   | |   | |
+ +-+-+-+ + +-+-+-+-+-+ +-+-+-+ +
|         |             |       |
+ +-+-+ + +-+-+-+-+-+-+-+ +-+-+ +
|     | | |   |   |   | | |     |
+ +-+ + + + +-+-+-+-+ + + + +-+ +
|   | | | | |       | | | | |   |
+-+ + + +-+-+ +-+-+ +-+ + + + +-+
| | | |   | | |G  |     | | | | |
+ + + +-+ + + + + + +-+ +-+ + + +
| | | |   | |     | | |   | | | |
+-+ + + + +-+ +-+-+ +-+ + + + +-+
|   | | | | |       | | | | |   |
+ +-+ + + + +-+-+-+-+ + + + +-+ +
|     | | |   |   |   | | |     |
+ + +-+ + +-+-+-+-+-+-+-+ +-+-+ +
| |     |       |     |       | |
+ +-+-+-+-+-+-+-+-+-+ + +-+-+-+ +
| |   | |             | | |   | |
+ + +-+-+ +-+-+ +-+-+-+ +-+-+ + +
| | |     |     |     |     | | |
+ + + +-+ + +-+-+-+-+ + +-+ + + +
| | | | | | |       | | | | | | |
+ +-+ +-+ + + +-+-+ + + +-+ +-+ +
|             |   |       |     |
+-+-+-+-+-+-+-+-+-+-+-+-+-+-+-+-+
